!SIL SIL
<unk> SPN
अ	अ
अंकित	अ ं क ि त
अंग	अ ं ग
अंगप्रदर्शनलाई	अ ं ग प ् र द र ् श न ल ा ई
अंग्रेजी	अ ं ग ् र े ज ी
अंश	अ ं श
अंशुवर्माको	अ ं श ु व र ् म ा क ो
अइल्यान्डको	अ इ ल ् य ा न ् ड क ो
अउबेमा	अ उ ब े म ा
अउमेलसका	अ उ म े ल स क ा
अकल्यान्डमा	अ क ल ् य ा न ् ड म ा
अकाडेमी	अ क ा ड े म ी
अकाडेमीले	अ क ा ड े म ी ल े
अकालमा	अ क ा ल म ा
अक्टोबर	अ क ् ट ो ब र
अक्षर	अ क ् ष र
अक्षरहरू	अ क ् ष र ह र ू
अगष्टमा	अ ग ष ् ट म ा
अगस्ट	अ ग स ् ट
अगस्टमा	अ ग स ् ट म ा
अगस्त	अ ग स ् त
अगाडि	अ ग ा ड ि
अगाडिसम्म	अ ग ा ड ि स म ् म
अगाडी	अ ग ा ड ी
अग्नि	अ ग ् न ि
अग्रगामी	अ ग ् र ग ा म ी
अग्रिम	अ ग ् र ि म
अग्लो	अ ग ् ल ो
अघि	अ घ ि
अङडेन	अ ङ ड े न
अङ्कहरू	अ ङ ् क ह र ू
अङ्ग	अ ङ ् ग
अङ्गको	अ ङ ् ग क ो
अङ्ग्रेजी	अ ङ ् ग ् र े ज ी
अङ्ग्रेजीमा	अ ङ ् ग ् र े ज ी म ा
अचानक	अ च ा न क
अछाम	अ छ ा म
अजरबैजानको	अ ज र ब ै ज ा न क ो
अजाइल	अ ज ा इ ल
अझै	अ झ ै
अञ्चल	अ ञ ् च ल
अञ्चलको	अ ञ ् च ल क ो
अञ्चलमा	अ ञ ् च ल म ा
अञ्जु	अ ञ ् ज ु
अट्चालिस	अ ट ् च ा ल ि स
अट्ठाइस	अ ट ् ठ ा इ स
अट्ठाइसमा	अ ट ् ठ ा इ स म ा
अट्तीस	अ ट ् त ी स
अट्सट्ठी	अ ट ् स ट ् ठ ी
अट्सट्ठीमा	अ ट ् स ट ् ठ ी म ा
अठहत्तरमा	अ ठ ह त ् त र म ा
अठार	अ ठ ा र
अठारौँ	अ ठ ा र ौ ँ
अठासी	अ ठ ा स ी
अडियो	अ ड ि य ो
अड्डा	अ ड ् ड ा
अतिथि	अ त ि थ ि
अतियथार्थवादी	अ त ि य थ ा र ् थ व ा द ी
अतिरिक्त	अ त ि र ि क ् त
अत्यधिक	अ त ् य ध ि क
अत्यन्त	अ त ् य न ् त
अत्यन्तै	अ त ् य न ् त ै
अदालत	अ द ा ल त
अदालतमा	अ द ा ल त म ा
अदुवा	अ द ु व ा
अदैत्यवाद	अ द ै त ् य व ा द
अद्वितीय	अ द ् व ि त ी य
अधिक	अ ध ि क
अधिकांश	अ ध ि क ा ं श
अधिकार	अ ध ि क ा र
अधिकारी	अ ध ि क ा र ी
अधिकारीलाई	अ ध ि क ा र ी ल ा ई
अधिकारीले	अ ध ि क ा र ी ल े
अधिकृत	अ ध ि क ृ त
अधिकृतमा	अ ध ि क ृ त म ा
अधिराज्यकै	अ ध ि र ा ज ् य क ै
अधिराज्यसँग	अ ध ि र ा ज ् य स ँ ग
अध्यक्ष	अ ध ् य क ् ष
अध्यक्षको	अ ध ् य क ् ष क ो
अध्यक्षता	अ ध ् य क ् ष त ा
अध्ययन	अ ध ् य य न
अध्ययनरत	अ ध ् य य न र त
अध्येता	अ ध ् य े त ा
अन	अ न
अनमोल	अ न म ो ल
अनलाइन	अ न ल ा इ न
अनवरत	अ न व र त
अनाज	अ न ा ज
अनिकालको	अ न ि क ा ल क ो
अनु	अ न ु
अनुक्रम	अ न ु क ् र म
अनुगमनका	अ न ु ग म न क ा
अनुदान	अ न ु द ा न
अनुपात	अ न ु प ा त
अनुप्रयोगहरू	अ न ु प ् र य ो ग ह र ू
अनुभव	अ न ु भ व
अनुमति	अ न ु म त ि
अनुमान	अ न ु म ा न
अनुवादक	अ न ु व ा द क
अनुसन्धान	अ न ु स न ् ध ा न
अनुसरण	अ न ु स र ण
अनुसार	अ न ु स ा र
अनेक	अ न े क
अनौठो	अ न ौ ठ ो
अन्जु	अ न ् ज ु
अन्टार्क्टिका	अ न ् ट ा र ् क ् ट ि क ा
अन्टार्टिकाको	अ न ् ट ा र ् ट ि क ा क ो
अन्ठानब्बे	अ न ् ठ ा न ब ् ब े
अन्ठानब्बेऔँ	अ न ् ठ ा न ब ् ब े औ ँ
अन्ठानब्बेमा	अ न ् ठ ा न ब ् ब े म ा
अन्त	अ न ् त
अन्ततिर	अ न ् त त ि र
अन्तरगत	अ न ् त र ग त
अन्तरराज्यीय	अ न ् त र र ा ज ् य ी य
अन्तरराष्ट्रिय	अ न ् त र र ा ष ् ट ् र ि य
अन्तरार्ष्ट्रिय	अ न ् त र ा र ् ष ् ट ् र ि य
अन्तराष्ट्रिय	अ न ् त र ा ष ् ट ् र ि य
अन्तरिक्ष	अ न ् त र ि क ् ष
अन्तरिक्षउडान	अ न ् त र ि क ् ष उ ड ा न
अन्तर्गत	अ न ् त र ् ग त
अन्तर्गतको	अ न ् त र ् ग त क ो
अन्तर्राष्ट्रिय	अ न ् त र ् र ा ष ् ट ् र ि य
अन्तर्विनिमय	अ न ् त र ् व ि न ि म य
अन्तिम	अ न ् त ि म
अन्तोनियो	अ न ् त ो न ि य ो
अन्त्य	अ न ् त ् य
अन्धकारको	अ न ् ध क ा र क ो
अन्धवेगमा	अ न ् ध व े ग म ा
अन्न	अ न ् न
अन्नपूर्ण	अ न ् न प ू र ् ण
अन्नबालीको	अ न ् न ब ा ल ी क ो
अन्य	अ न ् य
अन्योलग्रस्त	अ न ् य ो ल ग ् र स ् त
अप	अ प
अपनाउनु	अ प न ा उ न ु
अपनाउने	अ प न ा उ न े
अपराध	अ प र ा ध
अपराधीहरूका	अ प र ा ध ी ह र ू क ा
अपरेसन	अ प र े स न
अपहरण	अ प ह र ण
अपहरणका	अ प ह र ण क ा
अपाङ्ग	अ प ा ङ ् ग
अपेक्षाकृत	अ प े क ् ष ा क ृ त
अप्टिकल	अ प ् ट ि क ल
अप्रवासी	अ प ् र व ा स ी
अप्रिल	अ प ् र ि ल
अफ	अ फ
अफगानिस्तान	अ फ ग ा न ि स ् त ा न
अफगानिस्तानमा	अ फ ग ा न ि स ् त ा न म ा
अफसेट	अ फ स े ट
अफ्गानिस्तानकस	अ फ ् ग ा न ि स ् त ा न क स
अफ्गानिस्तानको	अ फ ् ग ा न ि स ् त ा न क ो
अफ्रिकाको	अ फ ् र ि क ा क ो
अफ्रिकामा	अ फ ् र ि क ा म ा
अफ्रिकालाई	अ फ ् र ि क ा ल ा ई
अफ्रिकी	अ फ ् र ि क ी
अफ्रीकी	अ फ ् र ी क ी
अब	अ ब
अबखाज	अ ब ख ा ज
अबदेखि	अ ब द े ख ि
अबरुद्ध	अ ब र ु द ् ध
अबोव्यान	अ ब ो व ् य ा न
अब्बेस	अ ब ् ब े स
अभर	अ भ र
अभाव	अ भ ा व
अभावले	अ भ ा व ल े
अभिनय	अ भ ि न य
अभिनयको	अ भ ि न य क ो
अभिनित	अ भ ि न ि त
अभिनेता	अ भ ि न े त ा
अभिनेत्री	अ भ ि न े त ् र ी
अभिनेत्रीका	अ भ ि न े त ् र ी क ा
अभिनेत्रीको	अ भ ि न े त ् र ी क ो
अभिनेत्रीहरुले	अ भ ि न े त ् र ी ह र ु ल े
अभिलेख	अ भ ि ल े ख
अभिलेखमा	अ भ ि ल े ख म ा
अभिवक्ता	अ भ ि व क ् त ा
अभिवक्तालाई	अ भ ि व क ् त ा ल ा ई
अभिवृद्धि	अ भ ि व ृ द ् ध ि
अभिव्यक्तिका	अ भ ि व ् य क ् त ि क ा
अभिव्यक्तिमा	अ भ ि व ् य क ् त ि म ा
अभिव्यक्तिलाई	अ भ ि व ् य क ् त ि ल ा ई
अभ्यास	अ भ ् य ा स
अमनचयनको	अ म न च य न क ो
अमरकोष	अ म र क ो ष
अमरगढी	अ म र ग ढ ी
अमरगढीको	अ म र ग ढ ी क ो
अमृत	अ म ृ त
अमृता	अ म ृ त ा
अमेजन	अ म े ज न
अमेरिकन	अ म े र ि क न
अमेरिका	अ म े र ि क ा
अमेरिकाका	अ म े र ि क ा क ा
अमेरिकाको	अ म े र ि क ा क ो
अमेरिकामा	अ म े र ि क ा म ा
अमेरिकामै	अ म े र ि क ा म ै
अमेरिकाले	अ म े र ि क ा ल े
अमेरिकी	अ म े र ि क ी
अमेरिसोर्सबर्गन	अ म े र ि स ो र ् स ब र ् ग न
अम्बा	अ म ् ब ा
अरकिडोनिक	अ र क ि ड ो न ि क
अरनिको	अ र न ि क ो
अरब	अ र ब
अरबको	अ र ब क ो
अरबी	अ र ब ी
अरु	अ र ु
अरुण	अ र ु ण
अरुणिमा	अ र ु ण ि म ा
अरू	अ र ू
अरेबी	अ र े ब ी
अर्की	अ र ् क ी
अर्को	अ र ् क ो
अर्कोमा	अ र ् क ो म ा
अर्घाखाँची	अ र ् घ ा ख ा ँ च ी
अर्घाखाँचीको	अ र ् घ ा ख ा ँ च ी क ो
अर्जेन्टिनाका	अ र ् ज े न ् ट ि न ा क ा
अर्जेन्टिनाको	अ र ् ज े न ् ट ि न ा क ो
अर्थ	अ र ् थ
अर्थमा	अ र ् थ म ा
अर्थववेद	अ र ् थ व व े द
अर्थविद्	अ र ् थ व ि द ्
अर्थशास्त्रमा	अ र ् थ श ा स ् त ् र म ा
अर्थशास्त्री	अ र ् थ श ा स ् त ् र ी
अर्थात्	अ र ् थ ा त ्
अर्थोडक्स	अ र ् थ ो ड क ् स
अर्थोपेडीक	अ र ् थ ो प े ड ी क
अर्धचालक	अ र ् ध च ा ल क
अर्धव्यास	अ र ् ध व ् य ा स
अर्मेनियन	अ र ् म े न ि य न
अर्मेनियाको	अ र ् म े न ि य ा क ो
अर्वुद	अ र ् व ु द
अलग	अ ल ग
अलवण	अ ल व ण
अलान्ड	अ ल ा न ् ड
अल्काइल	अ ल ् क ा इ ल
अल्कोहल	अ ल ् क ो ह ल
अल्पसंख्यक	अ ल ् प स ं ख ् य क
अल्पाइन	अ ल ् प ा इ न
अल्प्समा	अ ल ् प ् स म ा
अल्बर्टाको	अ ल ् ब र ् ट ा क ो
अल्बानिया	अ ल ् ब ा न ि य ा
अल्बानियामा	अ ल ् ब ा न ि य ा म ा
अवधि	अ व ध ि
अवधिभरि	अ व ध ि भ र ि
अवरुद्ध	अ व र ु द ् ध
अवलम्बन	अ व ल म ् ब न
अवशेष	अ व श े ष
अवश्य	अ व श ् य
अवसर	अ व स र
अवस्था	अ व स ् थ ा
अवस्थाको	अ व स ् थ ा क ो
अवस्थामा	अ व स ् थ ा म ा
अवस्थासम्म	अ व स ् थ ा स म ् म
अवस्थित	अ व स ् थ ि त
अवस्थीको	अ व स ् थ ी क ो
अविच्छिन्न	अ व ि च ् छ ि न ् न
अशोक	अ श ो क
अश्लील	अ श ् ल ी ल
अष्ट्रेलियन	अ ष ् ट ् र े ल ि य न
अष्ट्रेलियाका	अ ष ् ट ् र े ल ि य ा क ा
अष्ट्रेलियाली	अ ष ् ट ् र े ल ि य ा ल ी
असङ्ख्य	अ स ङ ् ख ् य
असन्तुष्ट	अ स न ् त ु ष ् ट
असफल	अ स फ ल
असलै	अ स ल ै
असार	अ स ा र
असी	अ स ी
असोजमा	अ स ो ज म ा
अस्ट्रिया	अ स ् ट ् र ि य ा
अस्ट्रियामा	अ स ् ट ् र ि य ा म ा
अस्ट्रियाली	अ स ् ट ् र ि य ा ल ी
अस्ट्रेलिया	अ स ् ट ् र े ल ि य ा
अस्ट्रेलियाको	अ स ् ट ् र े ल ि य ा क ो
अस्ट्रेलियाली	अ स ् ट ् र े ल ि य ा ल ी
अस्ट्रोनेसियाली	अ स ् ट ् र ो न े स ि य ा ल ी
अस्तित्वमै	अ स ् त ि त ् व म ै
अस्थायी	अ स ् थ ा य ी
अस्पताल	अ स ् प त ा ल
अस्पतालका	अ स ् प त ा ल क ा
अस्पतालको	अ स ् प त ा ल क ो
अस्पतालबाट	अ स ् प त ा ल ब ा ट
अस्पतालमा	अ स ् प त ा ल म ा
अस्पताललाई	अ स ् प त ा ल ल ा ई
अस्पतालले	अ स ् प त ा ल ल े
अस्पतालहरू	अ स ् प त ा ल ह र ू
अस्पतालहरूमध्ये	अ स ् प त ा ल ह र ू म ध ् य े
अस्वीकृत	अ स ् व ी क ृ त
अस्वीकृति	अ स ् व ी क ृ त ि
अस्सुरीहरूको	अ स ् स ु र ी ह र ू क ो
अहिले	अ ह ि ल े
अहिलेको	अ ह ि ल े क ो
अहिलेसम्म	अ ह ि ल े स म ् म
अोगमा	अ ो ग म ा
आँउछ	आ ँ उ छ
आँकडा	आ ँ क ड ा
आँकलनमा	आ ँ क ल न म ा
आँखा	आ ँ ख ा
आँखाको	आ ँ ख ा क ो
आँखामा	आ ँ ख ा म ा
आँधि	आ ँ ध ि
आँधीबेहरीको	आ ँ ध ी ब े ह र ी क ो
आइएनटिएल	आ इ ए न ट ि ए ल
आइएमआई	आ इ ए म आ ई
आइकन	आ इ क न
आइटी	आ इ ट ी
आइटीले	आ इ ट ी ल े
आइट्युन्स	आ इ ट ् य ु न ् स
आइतबार	आ इ त ब ा र
आइरहेको	आ इ र ह े क ो
आइले	आ इ ल े
आइल्यान्डकाको	आ इ ल ् य ा न ् ड क ा क ो
आइल्यान्डको	आ इ ल ् य ा न ् ड क ो
आइल्यान्डमा	आ इ ल ् य ा न ् ड म ा
आइस	आ इ स
आइसकेको	आ इ स क े क ो
आइसल्यान्ड	आ इ स ल ् य ा न ् ड
आई	आ ई
आउँछ	आ उ ँ छ
आउँछन्	आ उ ँ छ न ्
आउँदै	आ उ ँ द ै
आउटपुट	आ उ ट प ु ट
आउन	आ उ न
आउनकै	आ उ न क ै
आउनु	आ उ न ु
आउनुभएकी	आ उ न ु भ ए क ी
आउनुभएको	आ उ न ु भ ए क ो
आउने	आ उ न े
आए	आ ए
आएका	आ ए क ा
आएकी	आ ए क ी
आएको	आ ए क ो
आएर	आ ए र
आकर्षण	आ क र ् ष ण
आकाङ्क्षा	आ क ा ङ ् क ् ष ा
आकार	आ क ा र
आकाश	आ क ा श
आकाशका	आ क ा श क ा
आकाशगंगाको	आ क ा श ग ं ग ा क ो
आकासगङ्गा	आ क ा स ग ङ ् ग ा
आकासचुम्बी	आ क ा स च ु म ् ब ी
आक्रमण	आ क ् र म ण
आक्रमणको	आ क ् र म ण क ो
आक्रमणहरूका	आ क ् र म ण ह र ू क ा
आक्रामक	आ क ् र ा म क
आगामी	आ ग ा म ी
आगो	आ ग ो
आग्रह	आ ग ् र ह
आग्रा	आ ग ् र ा
आङ्ग्ल	आ ङ ् ग ् ल
आचमन	आ च म न
आचार्य	आ च ा र ् य
आचार्यको	आ च ा र ् य क ो
आचार्यले	आ च ा र ् य ल े
आचेनमा	आ च े न म ा
आज	आ ज
आजकल	आ ज क ल
आजकाल	आ ज क ा ल
आजको	आ ज क ो
आजभोलि	आ ज भ ो ल ि
आजसम्म	आ ज स म ् म
आजा	आ ज ा
आठ	आ ठ
आठको	आ ठ क ो
आठमा	आ ठ म ा
आठसय	आ ठ स य
आदर्श	आ द र ् श
आदि	आ द ि
आदिको	आ द ि क ो
आदिमा	आ द ि म ा
आदिसँग	आ द ि स ँ ग
आदेश	आ द े श
आधार	आ ध ा र
आधारबाट	आ ध ा र ब ा ट
आधारभूत	आ ध ा र भ ू त
आधारमा	आ ध ा र म ा
आधारहरूद्वारा	आ ध ा र ह र ू द ् व ा र ा
आधारित	आ ध ा र ि त
आधिकारिक	आ ध ि क ा र ि क
आधिकारीक	आ ध ि क ा र ी क
आधुनिक	आ ध ु न ि क
आधुनिकतावादी	आ ध ु न ि क त ा व ा द ी
आनन्	आ न न ्
आनुवांशिकता	आ न ु व ा ं श ि क त ा
आन्तरिक	आ न ् त र ि क
आन्दोलन	आ न ् द ो ल न
आन्दोलनको	आ न ् द ो ल न क ो
आन्दोलनमा	आ न ् द ो ल न म ा
आपसमा	आ प स म ा
आपसिय	आ प स ि य
आपूर्ति	आ प ू र ् त ि
आफू	आ फ ू
आफूभन्दा	आ फ ू भ न ् द ा
आफूलाई	आ फ ू ल ा ई
आफूले	आ फ ू ल े
आफूसँग	आ फ ू स ँ ग
आफै	आ फ ै
आफ्ना	आ फ ् न ा
आफ्नै	आ फ ् न ै
आफ्नो	आ फ ् न ो
आफ्नोमार्ग	आ फ ् न ो म ा र ् ग
आम	आ म
आमा	आ म ा
आम्दानी	आ म ् द ा न ी
आयरल्यान्ड	आ य र ल ् य ा न ् ड
आयरल्यान्डको	आ य र ल ् य ा न ् ड क ो
आयर्समा	आ य र ् स म ा
आयाम	आ य ा म
आयामिक	आ य ा म ि क
आयु	आ य ु
आयुर्वेद	आ य ु र ् व े द
आयो	आ य ो
आयोजना	आ य ो ज न ा
आयोजनाको	आ य ो ज न ा क ो
आयोजित	आ य ो ज ि त
आर	आ र
आरक्षण	आ र क ् ष ण
आराध्यदेवका	आ र ा ध ् य द े व क ा
आरुबखडा	आ र ु ब ख ड ा
आरोप	आ र ो प
आरोही	आ र ो ह ी
आर्कडियोसिसमा	आ र ् क ड ि य ो स ि स म ा
आर्किटेक्ट	आ र ् क ि ट े क ् ट
आर्किडोनिक	आ र ् क ि ड ो न ि क
आर्चर	आ र ् च र
आर्ट	आ र ् ट
आर्थिक	आ र ् थ ि क
आर्मीका	आ र ् म ी क ा
आर्मीकै	आ र ् म ी क ै
आर्मेनियाको	आ र ् म े न ि य ा क ो
आर्य	आ र ् य
आर्यन	आ र ् य न
आर्यभट्टको	आ र ् य भ ट ् ट क ो
आर्यभट्टीयका	आ र ् य भ ट ् ट ी य क ा
आलु	आ ल ु
आल्प्स	आ ल ् प ् स
आल्प्समा	आ ल ् प ् स म ा
आवश्यक	आ व श ् य क
आवश्यकता	आ व श ् य क त ा
आवश्यकताभन्दा	आ व श ् य क त ा भ न ् द ा
आवस्थित	आ व स ् थ ि त
आवाज	आ व ा ज
आवाजको	आ व ा ज क ो
आवासिय	आ व ा स ि य
आविष्कारक	आ व ि ष ् क ा र क
आविष्कारका	आ व ि ष ् क ा र क ा
आशा	आ श ा
आश्रम	आ श ् र म
आश्वस	आ श ् व स
आसपासको	आ स प ा स क ो
इआइ	इ आ इ
इकाइ	इ क ा इ
इक्विटी	इ क ् व ि ट ी
इगोर	इ ग ो र
इङल्यान्डको	इ ङ ल ् य ा न ् ड क ो
इङ्लिस	इ ङ ् ल ि स
इङ्ल्यान्डका	इ ङ ् ल ् य ा न ् ड क ा
इचर	इ च र
इच्छा	इ च ् छ ा
इजरायली	इ ज र ा य ल ी
इजलासका	इ ज ल ा स क ा
इजाजत	इ ज ा ज त
इजिप्टको	इ ज ि प ् ट क ो
इजिप्टमा	इ ज ि प ् ट म ा
इजिप्टी	इ ज ि प ् ट ी
इटलीको	इ ट ल ी क ो
इटलीले	इ ट ल ी ल े
इटहरी	इ ट ह र ी
इटालियन	इ ट ा ल ि य न
इटाली	इ ट ा ल ी
इटालीको	इ ट ा ल ी क ो
इटालीमा	इ ट ा ल ी म ा
इटालेली	इ ट ा ल े ल ी
इडेन	इ ड े न
इतिहास	इ त ि ह ा स
इतिहासकार	इ त ि ह ा स क ा र
इतिहासबारे	इ त ि ह ा स ब ा र े
इतिहासमा	इ त ि ह ा स म ा
इतिहासविद्ले	इ त ि ह ा स व ि द ् ल े
इत्रबाट	इ त ् र ब ा ट
इथियोपियाली	इ थ ि य ो प ि य ा ल ी
इनकोड	इ न क ो ड
इनग्राममाइक्रो	इ न ग ् र ा म म ा इ क ् र ो
इनपुट	इ न प ु ट
इनर्जी	इ न र ् ज ी
इनर्जीले	इ न र ् ज ी ल े
इनाममा	इ न ा म म ा
इनोभेसन्सले	इ न ो भ े स न ् स ल े
इन्क	इ न ् क
इन्कका	इ न ् क क ा
इन्कको	इ न ् क क ो
इन्कमा	इ न ् क म ा
इन्कमार्फत	इ न ् क म ा र ् फ त
इन्कलाई	इ न ् क ल ा ई
इन्कले	इ न ् क ल े
इन्कसँग	इ न ् क स ँ ग
इन्कोडिङ	इ न ् क ो ड ि ङ
इन्चको	इ न ् च क ो
इन्जिनियर	इ न ् ज ि न ि य र
इन्टरनेट	इ न ् ट र न े ट
इन्टरनेटकार्य	इ न ् ट र न े ट क ा र ् य
इन्टरनेसनल	इ न ् ट र न े स न ल
इन्टरप्राइज	इ न ् ट र प ् र ा इ ज
इन्टरप्रेटेसन	इ न ् ट र प ् र े ट े स न
इन्टेल	इ न ् ट े ल
इन्डस्ट्रियल	इ न ् ड स ् ट ् र ि य ल
इन्डिजका	इ न ् ड ि ज क ा
इन्डोनेसिया	इ न ् ड ो न े स ि य ा
इन्डोनेसियाको	इ न ् ड ो न े स ि य ा क ो
इन्डोनेसियामा	इ न ् ड ो न े स ि य ा म ा
इन्डोनेसियाली	इ न ् ड ो न े स ि य ा ल ी
इन्तान्बुलमा	इ न ् त ा न ् ब ु ल म ा
इन्दी	इ न ् द ी
इन्द्रजात्राको	इ न ् द ् र ज ा त ् र ा क ो
इन्द्रराज्य	इ न ् द ् र र ा ज ् य
इन्धनका	इ न ् ध न क ा
इन्फरमेसन	इ न ् फ र म े स न
इन्फोसिसका	इ न ् फ ो स ि स क ा
इन्भेस्टमेन्ट	इ न ् भ े स ् ट म े न ् ट
इन्स्टिच्युट	इ न ् स ् ट ि च ् य ु ट
इन्स्योरेन्स	इ न ् स ् य ो र े न ् स
इबिपर्ल्सले	इ ब ि प र ् ल ् स ल े
इमान्दार	इ म ा न ् द ा र
इमिरेट्सको	इ म ि र े ट ् स क ो
इम्याजिन	इ म ् य ा ज ि न
इरानको	इ र ा न क ो
इल	इ ल
इलका	इ ल क ा
इलकी	इ ल क ी
इलरी	इ ल र ी
इलले	इ ल ल े
इलाका	इ ल ा क ा
इलाम	इ ल ा म
इलामतिर	इ ल ा म त ि र
इलेक्	इ ल े क ्
इलेक्ट्रनिक	इ ल े क ् ट ् र न ि क
इलेक्ट्रनिक्स	इ ल े क ् ट ् र न ि क ् स
इलेक्ट्रोनले	इ ल े क ् ट ् र ो न ल े
इलेक्ट्रोनहरू	इ ल े क ् ट ् र ो न ह र ू
इलेक्ट्रोनिक	इ ल े क ् ट ् र ो न ि क
इसपका	इ स प क ा
इस्ट	इ स ् ट
इस्टोनिया	इ स ् ट ो न ि य ा
इस्ताम्बुलमा	इ स ् त ा म ् ब ु ल म ा
इस्फाहन	इ स ् फ ा ह न
इस्लाम	इ स ् ल ा म
इस्वी	इ स ् व ी
ई	ई
ईन्जिनियरिङ्	ई न ् ज ि न ि य र ि ङ ्
ईशापूर्व	ई श ा प ू र ् व
ईशापूर्वसम्म	ई श ा प ू र ् व स म ् म
ईश्वरको	ई श ् व र क ो
ईसापूर्व	ई स ा प ू र ् व
उक्त	उ क ् त
उचाइका	उ च ा इ क ा
उचाइमा	उ च ा इ म ा
उच्च	उ च ् च
उच्चतम	उ च ् च त म
उच्चवर्गले	उ च ् च व र ् ग ल े
उच्चवृद्धि	उ च ् च व ृ द ् ध ि
उच्चस्तर	उ च ् च स ् त र
उच्चस्तरको	उ च ् च स ् त र क ो
उजागर	उ ज ा ग र
उज्बेकिस्तानको	उ ज ् ब े क ि स ् त ा न क ो
उज्बेकिस्तानमा	उ ज ् ब े क ि स ् त ा न म ा
उज्यालो	उ ज ् य ा ल ो
उडान	उ ड ा न
उडानमा	उ ड ा न म ा
उडेका	उ ड े क ा
उडेको	उ ड े क ो
उतकको	उ त क क ो
उत्	उ त ्
उत्कृष्ट	उ त ् क ृ ष ् ट
उत्खननमा	उ त ् ख न न म ा
उत्खनन्को	उ त ् ख न न ् क ो
उत्तम	उ त ् त म
उत्तर	उ त ् त र
उत्तरका	उ त ् त र क ा
उत्तरको	उ त ् त र क ो
उत्तरकोरियाका	उ त ् त र क ो र ि य ा क ा
उत्तरतर्फ	उ त ् त र त र ् फ
उत्तरतिर	उ त ् त र त ि र
उत्तरदक्षिण	उ त ् त र द क ् ष ि ण
उत्तरपश्चिम	उ त ् त र प श ् च ि म
उत्तरपश्चिमी	उ त ् त र प श ् च ि म ी
उत्तरबाट	उ त ् त र ब ा ट
उत्तरमा	उ त ् त र म ा
उत्तराधिकारी	उ त ् त र ा ध ि क ा र ी
उत्तराधिकारीका	उ त ् त र ा ध ि क ा र ी क ा
उत्तराधिकारीको	उ त ् त र ा ध ि क ा र ी क ो
उत्तरी	उ त ् त र ी
उत्तेस	उ त ् त े स
उत्त्पत्ति	उ त ् त ् प त ् त ि
उत्पति	उ त ् प त ि
उत्पतिका	उ त ् प त ि क ा
उत्पत्ति	उ त ् प त ् त ि
उत्पदनहरू	उ त ् प द न ह र ू
उत्पन्न	उ त ् प न ् न
उत्पादन	उ त ् प ा द न
उत्पादनको	उ त ् प ा द न क ो
उत्पादनहरू	उ त ् प ा द न ह र ू
उत्पादनहरूको	उ त ् प ा द न ह र ू क ो
उत्पादनहरूलाई	उ त ् प ा द न ह र ू ल ा ई
उत्पादित	उ त ् प ा द ि त
उत्रिएकी	उ त ् र ि ए क ी
उत्रिने	उ त ् र ि न े
उत्सव	उ त ् स व
उथलपुथल	उ थ ल प ु थ ल
उदय	उ द य
उदयपुर	उ द य प ु र
उदयपुरको	उ द य प ु र क ो
उदित	उ द ि त
उद्गम	उ द ् ग म
उद्गमसँग	उ द ् ग म स ँ ग
उद्गमस्थल	उ द ् ग म स ् थ ल
उद्धारकोषलाई	उ द ् ध ा र क ो ष ल ा ई
उद्बोधन	उ द ् ब ो ध न
उद्यमी	उ द ् य म ी
उद्योगले	उ द ् य ो ग ल े
उन	उ न
उनका	उ न क ा
उनकी	उ न क ी
उनकै	उ न क ै
उनको	उ न क ो
उननसाट्ठीमा	उ न न स ा ट ् ठ ी म ा
उनन्चासमा	उ न न ् च ा स म ा
उनन्सत्तरीमा	उ न न ् स त ् त र ी म ा
उनबारेमा	उ न ब ा र े म ा
उनलाई	उ न ल ा ई
उनले	उ न ल े
उनान्चालिसमा	उ न ा न ् च ा ल ि स म ा
उनान्तिस	उ न ा न ् त ि स
उनान्तीस	उ न ा न ् त ी स
उनान्सत्तरी	उ न ा न ् स त ् त र ी
उनान्सत्तरीको	उ न ा न ् स त ् त र ी क ो
उनान्सत्तरीमा	उ न ा न ् स त ् त र ी म ा
उनी	उ न ी
उनीलाई	उ न ी ल ा ई
उनीसित	उ न ी स ि त
उनीहरूका	उ न ी ह र ू क ा
उनीहरूको	उ न ी ह र ू क ो
उनीहरूलाई	उ न ी ह र ू ल ा ई
उनीहरूले	उ न ी ह र ू ल े
उन्नइस	उ न ् न इ स
उन्नाइस	उ न ् न ा इ स
उन्नाइसमा	उ न ् न ा इ स म ा
उन्नाइसौँ	उ न ् न ा इ स ौ ँ
उन्नास	उ न ् न ा स
उप	उ प
उपकरण	उ प क र ण
उपकरणहरू	उ प क र ण ह र ू
उपकरणहरूको	उ प क र ण ह र ू क ो
उपखण्ड	उ प ख ण ् ड
उपचार	उ प च ा र
उपचारमा	उ प च ा र म ा
उपत्यका	उ प त ् य क ा
उपत्यकाका	उ प त ् य क ा क ा
उपत्यकाको	उ प त ् य क ा क ो
उपत्यकामा	उ प त ् य क ा म ा
उपत्यकालाई	उ प त ् य क ा ल ा ई
उपनिवेश	उ प न ि व े श
उपनिवेशहरू	उ प न ि व े श ह र ू
उपन्यास	उ प न ् य ा स
उपन्यासकार	उ प न ् य ा स क ा र
उपप्रमुखमा	उ प प ् र म ु ख म ा
उपभोक्ता	उ प भ ो क ् त ा
उपभोग्य	उ प भ ो ग ् य
उपमहानगरपालिका	उ प म ह ा न ग र प ा ल ि क ा
उपयुक्त	उ प य ु क ् त
उपयोगका	उ प य ो ग क ा
उपयोगिता	उ प य ो ग ि त ा
उपलब्ध	उ प ल ब ् ध
उपसाला	उ प स ा ल ा
उपस्थित	उ प स ् थ ि त
उपस्थिति	उ प स ् थ ि त ि
उपाधिसँगै	उ प ा ध ि स ँ ग ै
उपाध्याय	उ प ा ध ् य ा य
उपाय	उ प ा य
उपास्थित	उ प ा स ् थ ि त
उपियाँको	उ प ि य ा ँ क ो
उप्रेतीको	उ प ् र े त ी क ो
उप्रेतीसँग	उ प ् र े त ी स ँ ग
उफ्रने	उ फ ् र न े
उबुन्टुमा	उ ब ु न ् ट ु म ा
उब्जनी	उ ब ् ज न ी
उमेरमा	उ म े र म ा
उमेश	उ म े श
उम्मेदवार	उ म ् म े द व ा र
उरसा	उ र स ा
उर्मिला	उ र ् म ि ल ा
उल्लङ्घन	उ ल ् ल ङ ् घ न
उल्लेख	उ ल ् ल े ख
उल्लेखनीय	उ ल ् ल े ख न ी य
उषा	उ ष ा
उसले	उ स ल े
उसिनिन्छ	उ स ि न ि न ् छ
उस्तै	उ स ् त ै
उहाँ	उ ह ा ँ
उहाँकै	उ ह ा ँ क ै
उहाँको	उ ह ा ँ क ो
उहाँलाई	उ ह ा ँ ल ा ई
उहाँले	उ ह ा ँ ल े
ऊर्जा	ऊ र ् ज ा
ऋचा	ऋ च ा
ऋतुमा	ऋ त ु म ा
ऋतुहरू	ऋ त ु ह र ू
ऋषि	ऋ ष ि
ए	ए
एआइजी	ए आ इ ज ी
एउटा	ए उ ट ा
एउटालाई	ए उ ट ा ल ा ई
एक	ए क
एकचालिस	ए क च ा ल ि स
एकचालिसमा	ए क च ा ल ि स म ा
एकचालिसौँ	ए क च ा ल ि स ौ ँ
एकतिस	ए क त ि स
एकत्र	ए क त ् र
एकदमै	ए क द म ै
एकपटक	ए क प ट क
एकबाट	ए क ब ा ट
एकमात्र	ए क म ा त ् र
एकर्स	ए क र ् स
एकल	ए क ल
एकसट्ठी	ए क स ट ् ठ ी
एकसय	ए क स य
एकहत्तरको	ए क ह त ् त र क ो
एकहत्तरमा	ए क ह त ् त र म ा
एकाइ	ए क ा इ
एकाइहरूको	ए क ा इ ह र ू क ो
एकाउन्न	ए क ा उ न ् न
एकानब्बेमा	ए क ा न ब ् ब े म ा
एकान्त	ए क ा न ् त
एकान्तमा	ए क ा न ् त म ा
एकाबिहानै	ए क ा ब ि ह ा न ै
एकासी	ए क ा स ी
एकासीमा	ए क ा स ी म ा
एकिनफेभमाथि	ए क ि न फ े भ म ा थ ि
एकीकरणमा	ए क ी क र ण म ा
एकीकृत	ए क ी क ृ त
एकेडेमीले	ए क े ड े म ी ल े
एक्का	ए क ् क ा
एक्काइस	ए क ् क ा इ स
एक्काइसमा	ए क ् क ा इ स म ा
एक्काइसौँ	ए क ् क ा इ स ौ ँ
एक्सएक्सआइआई	ए क ् स ए क ् स आ इ आ ई
एक्सन	ए क ् स न
एक्सप्रेस	ए क ् स प ् र े स
एक्सोन	ए क ् स ो न
एक्स्पोमा	ए क ् स ् प ो म ा
एघार	ए घ ा र
एघारको	ए घ ा र क ो
एघारमा	ए घ ा र म ा
एघारवटा	ए घ ा र व ट ा
एघारौँ	ए घ ा र ौ ँ
एङ्लिकन	ए ङ ् ल ि क न
एचसिए	ए च स ि ए
एज	ए ज
एजेन्सीले	ए ज े न ् स ी ल े
एटलान्टिक	ए ट ल ा न ् ट ि क
एटाइपिडाइको	ए ट ा इ प ि ड ा इ क ो
एटिएम	ए ट ि ए म
एटी	ए ट ी
एडमन्ड	ए ड म न ् ड
एडवर्ड	ए ड व र ् ड
एण्ड	ए ण ् ड
एथेन्समा	ए थ े न ् स म ा
एन	ए न
एनएएचबी	ए न ए ए च ब ी
एनबिए	ए न ब ि ए
एनालग	ए न ा ल ग
एनास्कोटेसिया	ए न ा स ् क ो ट े स ि य ा
एनिम	ए न ि म
एनिमेटे	ए न ि म े ट े
एनिमेसन	ए न ि म े स न
एन्जलसमा	ए न ् ज ल स म ा
एन्टाल्या	ए न ् ट ा ल ् य ा
एन्ड	ए न ् ड
एन्डाइ	ए न ् ड ा इ
एन्डिनबर्गमा	ए न ् ड ि न ब र ् ग म ा
एन्डेस	ए न ् ड े स
एन्ड्रयू	ए न ् ड ् र य ू
एपिएफका	ए प ि ए फ क ा
एपिसोडको	ए प ि स ो ड क ो
एपिसोडहरूको	ए प ि स ो ड ह र ू क ो
एफ	ए फ
एफआइएस	ए फ आ इ ए स
एफस्टोन	ए फ स ् ट ो न
एब्बोट	ए ब ् ब ो ट
एम	ए म
एमई	ए म ई
एमालेका	ए म ा ल े क ा
एमिनो	ए म ि न ो
एयर	ए य र
एयरको	ए य र क ो
एरोन्डिस्मेन्ट	ए र ो न ् ड ि स ् म े न ् ट
एल	ए ल
एलिजावेथ	ए ल ि ज ा व े थ
एलोट्रोप	ए ल ो ट ् र ो प
एल्बम	ए ल ् ब म
एल्बमहरू	ए ल ् ब म ह र ू
एल्बमहरूको	ए ल ् ब म ह र ू क ो
एवं	ए व ं
एवम्	ए व म ्
एस	ए स
एसएलसीमा	ए स ए ल स ी म ा
एसिड	ए स ि ड
एसिडबा	ए स ि ड ब ा
एसिडबाट	ए स ि ड ब ा ट
एसियन	ए स ि य न
एसिया	ए स ि य ा
एसियाका	ए स ि य ा क ा
एसियाकै	ए स ि य ा क ै
एसियाको	ए स ि य ा क ो
एसियाडमा	ए स ि य ा ड म ा
एसियामा	ए स ि य ा म ा
एसियालाई	ए स ि य ा ल ा ई
एसियाली	ए स ि य ा ल ी
एसेह	ए स े ह
एसोसिएसन	ए स ो स ि ए स न
एसोसियटको	ए स ो स ि य ट क ो
एस्टोनियामा	ए स ् ट ो न ि य ा म ा
एेतिहासिक	ए े त ि ह ा स ि क
ऐतिहासिक	ऐ त ि ह ा स ि क
ऐन	ऐ न
ऐरको	ऐ र क ो
ऐरागोनको	ऐ र ा ग ो न क ो
ओआरटुके	ओ आ र ट ु क े
ओइसीको	ओ इ स ी क ो
ओक	ओ क
ओकलाई	ओ क ल ा ई
ओकोटोनाइडाइ	ओ क ो ट ो न ा इ ड ा इ
ओखलढुङ्गा	ओ ख ल ढ ु ङ ् ग ा
ओखलढुङ्गामा	ओ ख ल ढ ु ङ ् ग ा म ा
ओगटिसकेको	ओ ग ट ि स क े क ो
ओगटेको	ओ ग ट े क ो
ओझाको	ओ झ ा क ो
ओझेलमा	ओ झ े ल म ा
ओटागोमा	ओ ट ा ग ो म ा
ओडको	ओ ड क ो
ओत	ओ त
ओन्टारियोको	ओ न ् ट ा र ि य ो क ो
ओब्लास्ट	ओ ब ् ल ा स ् ट
ओब्लास्टको	ओ ब ् ल ा स ् ट क ो
ओब्लास्टमा	ओ ब ् ल ा स ् ट म ा
ओम	ओ म
ओरिजा	ओ र ि ज ा
ओरेन्ज	ओ र े न ् ज
ओर्लान्डो	ओ र ् ल ा न ् ड ो
ओलम्पिक	ओ ल म ् प ि क
ओलम्पिकमा	ओ ल म ् प ि क म ा
ओलीको	ओ ल ी क ो
औद्योगिक	औ द ् य ो ग ि क
औपचारिक	औ प च ा र ि क
औषधालय	औ ष ध ा ल य
औषधालयमा	औ ष ध ा ल य म ा
औषधालयलाई	औ ष ध ा ल य ल ा ई
औषधालयले	औ ष ध ा ल य ल े
औषधि	औ ष ध ि
औषधिको	औ ष ध ि क ो
औषधिहरू	औ ष ध ि ह र ू
क	क
कं	क ं
कंग्	क ं ग ्
कउफो	क उ फ ो
कक्षा	क क ् ष ा
कक्षामा	क क ् ष ा म ा
कङ्गोको	क ङ ् ग ो क ो
कञ्चनजङ्घा	क ञ ् च न ज ङ ् घ ा
कटारी	क ट ा र ी
कठपुतली	क ठ प ु त ल ी
कठायतका	क ठ ा य त क ा
कठिनाइ	क ठ ि न ा इ
कठै	क ठ ै
कठोर	क ठ ो र
कडालको	क ड ा ल क ो
कण	क ण
कणहरू	क ण ह र ू
कतिपय	क त ि प य
कतिपयले	क त ि प य ल े
कतिवटा	क त ि व ट ा
कतै	क त ै
कथन	क थ न
कथा	क थ ा
कथाका	क थ ा क ा
कथाको	क थ ा क ो
कथानक	क थ ा न क
कथाभित्रका	क थ ा भ ि त ् र क ा
कथामा	क थ ा म ा
कथालाई	क थ ा ल ा ई
कथाहरू	क थ ा ह र ू
कथाहरूको	क थ ा ह र ू क ो
कथाहरूजस्तै	क थ ा ह र ू ज स ् त ै
कथाहरूभित्र	क थ ा ह र ू भ ि त ् र
कदम	क द म
कदर	क द र
कन्काई	क न ् क ा ई
कन्टिनेन्टल	क न ् ट ि न े न ् ट ल
कन्ट्रिपप	क न ् ट ् र ि प प
कन्ट्रोल्स	क न ् ट ् र ो ल ् स
कन्भर्स	क न ् भ र ् स
कन्या	क न ् य ा
कन्सर्ट	क न ् स र ् ट
कन्सेप्सियन	क न ् स े प ् स ि य न
कप	क प
कपडा	क प ड ा
कपडाको	क प ड ा क ो
कपिलवस्तु	क प ि ल व स ् त ु
कप्तान	क प ् त ा न
कफहरूको	क फ ह र ू क ो
कफी	क फ ी
कबाबका	क ब ा ब क ा
कबाबमा	क ब ा ब म ा
कब्जा	क ब ् ज ा
कब्जामा	क ब ् ज ा म ा
कम	क म
कमको	क म क ो
कमजोर	क म ज ो र
कमर्स	क म र ् स
कमर्समा	क म र ् स म ा
कमर्सियल	क म र ् स ि य ल
कमल	क म ल
कमलनयनाचार्यको	क म ल न य न ा च ा र ् य क ो
कमला	क म ल ा
कमलामाई	क म ल ा म ा ई
कमले	क म ल े
कमाएका	क म ा ए क ा
कमाएको	क म ा ए क ो
कमी	क म ी
कमेडी	क म े ड ी
कम्	क म ्
कम्पनी	क म ् प न ी
कम्पनीका	क म ् प न ी क ा
कम्पनीज	क म ् प न ी ज
कम्पनीजले	क म ् प न ी ज ल े
कम्पनीबाट	क म ् प न ी ब ा ट
कम्पनीमा	क म ् प न ी म ा
कम्पनीलाई	क म ् प न ी ल ा ई
कम्पनीले	क म ् प न ी ल े
कम्पनीसँग	क म ् प न ी स ँ ग
कम्पनीहरूभन्दा	क म ् प न ी ह र ू भ न ् द ा
कम्पनीहरूसँग	क म ् प न ी ह र ू स ँ ग
कम्प्टयुटरद्वारा	क म ् प ् ट य ु ट र द ् व ा र ा
कम्प्युटर	क म ् प ् य ु ट र
कम्प्युटरको	क म ् प ् य ु ट र क ो
कम्प्युटरमा	क म ् प ् य ु ट र म ा
कम्प्युटरले	क म ् प ् य ु ट र ल े
कम्प्युटरहरू	क म ् प ् य ु ट र ह र ू
कम्बोडिया	क म ् ब ो ड ि य ा
कम्युनिकेसनले	क म ् य ु न ि क े स न ल े
कम्युनिकेसन्सले	क म ् य ु न ि क े स न ् स ल े
कम्युनिष्ट	क म ् य ु न ि ष ् ट
कम्युनिस्ट	क म ् य ु न ि स ् ट
कम्लेक्स	क म ् ल े क ् स
कर	क र
करमा	क र म ा
करिब	क र ि ब
करिश्मा	क र ि श ् म ा
करोड	क र ो ड
करोडको	क र ो ड क ो
करोडौँको	क र ो ड ौ ँ क ो
कर्कपेट्रिकले	क र ् क प े ट ् र ि क ल े
कर्कपेट्रीकले	क र ् क प े ट ् र ी क ल े
कर्णबहादुर	क र ् ण ब ह ा द ु र
कर्णाटक	क र ् ण ा ट क
कर्णाली	क र ् ण ा ल ी
कर्णालीमा	क र ् ण ा ल ी म ा
कर्नाटकको	क र ् न ा ट क क ो
कर्परेसनका	क र ् प र े स न क ा
कर्परेसनको	क र ् प र े स न क ो
कर्पोरेसन	क र ् प ो र े स न
कर्पोरेसनका	क र ् प ो र े स न क ा
कर्पोरेसनको	क र ् प ो र े स न क ो
कर्पोरेसनले	क र ् प ो र े स न ल े
कर्मचारी	क र ् म च ा र ी
कर्मचारीहरू	क र ् म च ा र ी ह र ू
कर्मचारीहरूलाई	क र ् म च ा र ी ह र ू ल ा ई
कर्मचारीहरूले	क र ् म च ा र ी ह र ू ल े
कलकत्ताकै	क ल क त ् त ा क ै
कलकबहादुर	क ल क ब ह ा द ु र
कलर्स	क ल र ् स
कला	क ल ा
कलाका	क ल ा क ा
कलाकार	क ल ा क ा र
कलाकारहरू	क ल ा क ा र ह र ू
कलाकारहरूद्वारा	क ल ा क ा र ह र ू द ् व ा र ा
कलाकारिता	क ल ा क ा र ि त ा
कलाघर	क ल ा घ र
कलेज	क ल े ज
कलेजको	क ल े ज क ो
कलेजबाट	क ल े ज ब ा ट
कलेजमा	क ल े ज म ा
कलेजले	क ल े ज ल े
कलेजी	क ल े ज ी
कल्पना	क ल ् प न ा
कवि	क व ि
कविताको	क व ि त ा क ो
कसरी	क स र ी
कसाइ	क स ा इ
कसैलाई	क स ै ल ा ई
कसैले	क स ै ल े
कस्तुरी	क स ् त ु र ी
कस्दरी	क स ् द र ी
कस्मेटिक	क स ् म े ट ि क
कस्सिएछन्	क स ् स ि ए छ न ्
कहलिन	क ह ल ि न
कहिल्यै	क ह ि ल ् य ै
काँक्रा	क ा ँ क ् र ा
काँडे	क ा ँ ड े
काउन्टी	क ा उ न ् ट ी
काउन्टीको	क ा उ न ् ट ी क ो
काउन्टीमा	क ा उ न ् ट ी म ा
काखमा	क ा ख म ा
काखीमा	क ा ख ी म ा
काग	क ा ग
कागज	क ा ग ज
कागजहरू	क ा ग ज ह र ू
कागजात	क ा ग ज ा त
कागजातहरू	क ा ग ज ा त ह र ू
काङ्ग्रेस	क ा ङ ् ग ् र े स
काङ्ग्रेसका	क ा ङ ् ग ् र े स क ा
काजकिस्तान	क ा ज क ि स ् त ा न
काट्छ	क ा ट ् छ
काठ	क ा ठ
काठका	क ा ठ क ा
काठमाडौँ	क ा ठ म ा ड ौ ँ
काठमाडौँका	क ा ठ म ा ड ौ ँ क ा
काठमाडौँबाट	क ा ठ म ा ड ौ ँ ब ा ट
काठमाडौँमा	क ा ठ म ा ड ौ ँ म ा
काठमाण्डु	क ा ठ म ा ण ् ड ु
काठमाण्डौ	क ा ठ म ा ण ् ड ौ
काण्डका	क ा ण ् ड क ा
कान	क ा न
काननहुने	क ा न न ह ु न े
काना	क ा न ा
कान्छा	क ा न ् छ ा
कान्ति	क ा न ् त ि
कापमा	क ा प म ा
काफ्ले	क ा फ ् ल े
काबेली	क ा ब े ल ी
काब्रु	क ा ब ् र ु
काम	क ा म
कामतिर	क ा म त ि र
कामदार	क ा म द ा र
कामदारहरू	क ा म द ा र ह र ू
कामदारहरूलाई	क ा म द ा र ह र ू ल ा ई
कामना	क ा म न ा
कामुक	क ा म ु क
कायम	क ा य म
कायमै	क ा य म ै
कार	क ा र
कारक	क ा र क
कारको	क ा र क ो
कारण	क ा र ण
कारणले	क ा र ण ल े
कार्की	क ा र ् क ी
कार्कीको	क ा र ् क ी क ो
कार्कीदेखि	क ा र ् क ी द े ख ि
कार्के	क ा र ् क े
कार्ड	क ा र ् ड
कार्डिनल	क ा र ् ड ि न ल
कार्बन	क ा र ् ब न
कार्मचारी	क ा र ् म च ा र ी
कार्य	क ा र ् य
कार्यकारिणी	क ा र ् य क ा र ि ण ी
कार्यकारिणीको	क ा र ् य क ा र ि ण ी क ो
कार्यकारी	क ा र ् य क ा र ी
कार्यको	क ा र ् य क ो
कार्यक्रम	क ा र ् य क ् र म
कार्यक्रमको	क ा र ् य क ् र म क ो
कार्यक्रमबाट	क ा र ् य क ् र म ब ा ट
कार्यक्रमहरू	क ा र ् य क ् र म ह र ू
कार्यमा	क ा र ् य म ा
कार्यरत	क ा र ् य र त
कार्यहरू	क ा र ् य ह र ू
कार्यालय	क ा र ् य ा ल य
कार्यालयका	क ा र ् य ा ल य क ा
कार्यालयमा	क ा र ् य ा ल य म ा
कार्यालयले	क ा र ् य ा ल य ल े
काल	क ा ल
कालको	क ा ल क ो
कालखण्डमा	क ा ल ख ण ् ड म ा
कालदेखि	क ा ल द े ख ि
कालाचुरी	क ा ल ा च ु र ी
कालान्तर	क ा ल ा न ् त र
कालापानीको	क ा ल ा प ा न ी क ो
कालासागरका	क ा ल ा स ा ग र क ा
कालिकोट	क ा ल ि क ो ट
कालिङ्पोङ	क ा ल ि ङ ् प ो ङ
कालिङ्पोङदेखि	क ा ल ि ङ ् प ो ङ द े ख ि
कालिङ्पोङमा	क ा ल ि ङ ् प ो ङ म ा
कालिनिनग्राड	क ा ल ि न ि न ग ् र ा ड
कालिन्चोक	क ा ल ि न ् च ो क
कालिम्पोङ	क ा ल ि म ् प ो ङ
कालिम्पोङ्ग	क ा ल ि म ् प ो ङ ् ग
काली	क ा ल ी
कालीकट	क ा ल ी क ट
कालीकटमा	क ा ल ी क ट म ा
कालीकण्ठे	क ा ल ी क ण ् ठ े
कालीका	क ा ल ी क ा
कालीको	क ा ल ी क ो
कालीकोट	क ा ल ी क ो ट
कालीखोला	क ा ल ी ख ो ल ा
कालीगण्डकी	क ा ल ी ग ण ् ड क ी
कालीझार	क ा ल ी झ ा र
कालीन	क ा ल ी न
कालीनदी	क ा ल ी न द ी
कालीनाग	क ा ल ी न ा ग
कालीबंगा	क ा ल ी ब ं ग ा
कालीबंगाको	क ा ल ी ब ं ग ा क ो
कालीबंगाबाट	क ा ल ी ब ं ग ा ब ा ट
कालीबङ्गाको	क ा ल ी ब ङ ् ग ा क ो
कालीमाटी	क ा ल ी म ा ट ी
कालुखेती	क ा ल ु ख े त ी
काले	क ा ल े
कालेगाँडा	क ा ल े ग ा ँ ड ा
कालेश्वर	क ा ल े श ् व र
कालो	क ा ल ो
कालोगर्दने	क ा ल ो ग र ् द न े
कालोटाउके	क ा ल ो ट ा उ क े
कालोपुच्छ्रे	क ा ल ो प ु च ् छ ् र े
कालोबंगा	क ा ल ो ब ं ग ा
कालोबुङेचरा	क ा ल ो ब ु ङ े च र ा
कालोलाई	क ा ल ो ल ा ई
काल्चे	क ा ल ् च े
काल्पनिक	क ा ल ् प न ि क
कावासोती	क ा व ा स ो त ी
कावेरी	क ा व े र ी
काव्य	क ा व ् य
काशीराज	क ा श ी र ा ज
काश्मिरी	क ा श ् म ि र ी
कासगंज	क ा स ग ं ज
कास्की	क ा स ् क ी
कास्कीको	क ा स ् क ी क ो
कास्ट्रोसित	क ा स ् ट ् र ो स ि त
काहुँ	क ा ह ु ँ
कि	क ि
किउलको	क ि उ ल क ो
किङ	क ि ङ
किङफिसर	क ि ङ फ ि स र
किचकवध	क ि च क व ध
किचन	क ि च न
किचनका	क ि च न क ा
किच्चक	क ि च ् च क
किच्चकको	क ि च ् च क क ो
किच्चकबध	क ि च ् च क ब ध
किच्चकबधको	क ि च ् च क ब ध क ो
किच्चकवध	क ि च ् च क व ध
किच्चकसँग	क ि च ् च क स ँ ग
किटिनी	क ि ट ि न ी
किटु	क ि ट ु
किताब	क ि त ा ब
कित्थे	क ि त ् थ े
किन	क ि न
किनभने	क ि न भ न े
किनारका	क ि न ा र क ा
किनारमा	क ि न ा र म ा
किनारामा	क ि न ा र ा म ा
किनेमा	क ि न े म ा
किनेमाको	क ि न े म ा क ो
किनेमालाई	क ि न े म ा ल ा ई
किन्डल	क ि न ् ड ल
किन्ताङ	क ि न ् त ा ङ
किन्नरकिन्नरी	क ि न ् न र क ि न ् न र ी
किन्ने	क ि न ् न े
किपट	क ि प ट
किबोर्ड	क ि ब ो र ् ड
किम	क ि म
किमका	क ि म क ा
किमको	क ि म क ो
किमडाँडा	क ि म ड ा ँ ड ा
किमलाई	क ि म ल ा ई
किमले	क ि म ल े
किमी	क ि म ी
कियभमा	क ि य भ म ा
कियानी	क ि य ा न ी
किरण	क ि र ण
किराँत	क ि र ा ँ त
किराँतकालमा	क ि र ा ँ त क ा ल म ा
किराँतभित्र	क ि र ा ँ त भ ि त ् र
किराँतमा	क ि र ा ँ त म ा
किराँतलाई	क ि र ा ँ त ल ा ई
किराँतहरूका	क ि र ा ँ त ह र ू क ा
किराँतहरूको	क ि र ा ँ त ह र ू क ो
किराँतहरूबाट	क ि र ा ँ त ह र ू ब ा ट
किराँतहरूलाई	क ि र ा ँ त ह र ू ल ा ई
किराँतहरूले	क ि र ा ँ त ह र ू ल े
किराँती	क ि र ा ँ त ी
किराको	क ि र ा क ो
किराना	क ि र ा न ा
किरावा	क ि र ा व ा
किराहरूको	क ि र ा ह र ू क ो
किलो	क ि ल ो
किलोमिटर	क ि ल ो म ि ट र
किलोमिटरको	क ि ल ो म ि ट र क ो
किलोमिटरभन्दा	क ि ल ो म ि ट र भ न ् द ा
किलोमिटरमा	क ि ल ो म ि ट र म ा
किल्ला	क ि ल ् ल ा
किष्ट	क ि ष ् ट
किसान	क ि स ा न
किसिमका	क ि स ि म क ा
किसिमको	क ि स ि म क ो
किसिमबाट	क ि स ि म ब ा ट
किस्मत	क ि स ् म त
कीर्तिपुरको	क ी र ् त ि प ु र क ो
कुइने	क ु इ न े
कुकले	क ु क ल े
कुकी	क ु क ी
कुकुरजत्रा	क ु क ु र ज त ् र ा
कुचो	क ु च ो
कुजुनामा	क ु ज ु न ा म ा
कुञ्जना	क ु ञ ् ज न ा
कुटाइ	क ु ट ा इ
कुटिकमा	क ु ट ि क म ा
कुण्ड	क ु ण ् ड
कुदृष्टि	क ु द ृ ष ् ट ि
कुनै	क ु न ै
कुन्ती	क ु न ् त ी
कुन्दे	क ु न ् द े
कुपोषण	क ु प ो ष ण
कुमार	क ु म ा र
कुमारको	क ु म ा र क ो
कुमारी	क ु म ा र ी
कुमारीपाटीमा	क ु म ा र ी प ा ट ी म ा
कुरा	क ु र ा
कुराकानी	क ु र ा क ा न ी
कुराको	क ु र ा क ो
कुराबाट	क ु र ा ब ा ट
कुरामा	क ु र ा म ा
कुराले	क ु र ा ल े
कुराहरू	क ु र ा ह र ू
कुराहरूको	क ु र ा ह र ू क ो
कुराहरूमाथि	क ु र ा ह र ू म ा थ ि
कुरूपको	क ु र ू प क ो
कुरूपतालाई	क ु र ू प त ा ल ा ई
कुरो	क ु र ो
कुल	क ु ल
कुलको	क ु ल क ो
कुलिग	क ु ल ि ग
कुलुङ	क ु ल ु ङ
कुश्मामा	क ु श ् म ा म ा
कृतक	क ृ त क
कृतकमा	क ृ त क म ा
कृति	क ृ त ि
कृतिबहादुर	क ृ त ि ब ह ा द ु र
कृतिम	क ृ त ि म
कृषक	क ृ ष क
कृषकले	क ृ ष क ल े
कृषि	क ृ ष ि
कृषिमै	क ृ ष ि म ै
कृष्टि	क ृ ष ् ट ि
कृष्टी	क ृ ष ् ट ी
कृष्ण	क ृ ष ् ण
कृष्णार्पन	क ृ ष ् ण ा र ् प न
के	क े
केकी	क े क ी
केको	क े क ो
केदार	क े द ा र
केन्द्र	क े न ् द ् र
केन्द्रको	क े न ् द ् र क ो
केन्द्रबाट	क े न ् द ् र ब ा ट
केन्द्रमा	क े न ् द ् र म ा
केन्द्रले	क े न ् द ् र ल े
केन्द्रहरूलाई	क े न ् द ् र ह र ू ल ा ई
केन्द्रित	क े न ् द ् र ि त
केन्द्रिय	क े न ् द ् र ि य
केन्द्रीय	क े न ् द ् र ी य
केप	क े प
केपमा	क े प म ा
केमियो	क े म ि य ो
केयरमार्कमा	क े य र म ा र ् क म ा
केरल	क े र ल
केरलका	क े र ल क ा
केरलको	क े र ल क ो
केरलमा	क े र ल म ा
केरा	क े र ा
केशर	क े श र
केशव	क े श व
केसी	क े स ी
केसीका	क े स ी क ा
केसीकी	क े स ी क ी
केसीको	क े स ी क ो
केसीले	क े स ी ल े
केही	क े ह ी
केहीले	क े ह ी ल े
कैलाली	क ै ल ा ल ी
कैलाश	क ै ल ा श
को	क ो
कोअली	क ो अ ल ी
कोइँच	क ो इ ँ च
कोइराला	क ो इ र ा ल ा
कोइरालाको	क ो इ र ा ल ा क ो
कोइरालालाई	क ो इ र ा ल ा ल ा ई
कोकेसियान	क ो क े स ि य ा न
कोखबाट	क ो ख ब ा ट
कोच	क ो च
कोट	क ो ट
कोड	क ो ड
कोणधारी	क ो ण ध ा र ी
कोत्रे	क ो त ् र े
कोत्रेखोलासम्म	क ो त ् र े ख ो ल ा स म ् म
कोनोकोफिलिप्सले	क ो न ो क ो फ ि ल ि प ् स ल े
कोपनहेगन	क ो प न ह े ग न
कोबोर्डको	क ो ब ो र ् ड क ो
कोमकास्टले	क ो म क ा स ् ट ल े
कोमल	क ो म ल
कोमी	क ो म ी
कोयाङ	क ो य ा ङ
कोयु	क ो य ु
कोरियन	क ो र ि य न
कोरिया	क ो र ि य ा
कोरियाका	क ो र ि य ा क ा
कोरियाको	क ो र ि य ा क ो
कोरियाली	क ो र ि य ा ल ी
कोरियाले	क ो र ि य ा ल े
कोलम्बिया	क ो ल म ् ब ि य ा
कोलम्बियाको	क ो ल म ् ब ि य ा क ो
कोलम्बियामा	क ो ल म ् ब ि य ा म ा
कोलम्बियाली	क ो ल म ् ब ि य ा ल ी
कोलम्वी	क ो ल म ् व ी
कोलोनका	क ो ल ो न क ा
कोलोनको	क ो ल ो न क ो
कोल्ट्रेनद्वारा	क ो ल ् ट ् र े न द ् व ा र ा
कोषहरूको	क ो ष ह र ू क ो
कोसिस	क ो स ि स
कोसीटप्पु	क ो स ी ट प ् प ु
कोसेलीको	क ो स े ल ी क ो
कौसीमा	क ौ स ी म ा
क्याटालोनियाको	क ् य ा ट ा ल ो न ि य ा क ो
क्याड	क ् य ा ड
क्याथोलिक	क ् य ा थ ो ल ि क
क्यानकुन	क ् य ा न क ु न
क्यानडा	क ् य ा न ड ा
क्यानडाको	क ् य ा न ड ा क ो
क्यानबराको	क ् य ा न ब र ा क ो
क्यानभास	क ् य ा न भ ा स
क्यानलले	क ् य ा न ल ल े
क्यानाडामा	क ् य ा न ा ड ा म ा
क्यानाडेली	क ् य ा न ा ड े ल ी
क्यान्टरबरी	क ् य ा न ् ट र ब र ी
क्यान्सर	क ् य ा न ् स र
क्यापिटल	क ् य ा प ि ट ल
क्याफे	क ् य ा फ े
क्याबरेट	क ् य ा ब र े ट
क्यामब्राईको	क ् य ा म ब ् र ा ई क ो
क्याम्पस	क ् य ा म ् प स
क्याम्पसबाट	क ् य ा म ् प स ब ा ट
क्याम्पसाइटमा	क ् य ा म ् प स ा इ ट म ा
क्याम्पियन	क ् य ा म ् प ि य न
क्यारी	क ् य ा र ी
क्यारोलिनको	क ् य ा र ो ल ि न क ो
क्यालिफोर्नियाको	क ् य ा ल ि फ ो र ् न ि य ा क ो
क्यालिफोर्नियामा	क ् य ा ल ि फ ो र ् न ि य ा म ा
क्यालेन्डरहरूको	क ् य ा ल े न ् ड र ह र ू क ो
क्यास्टाइल	क ् य ा स ् ट ा इ ल
क्यु	क ् य ु
क्युआर	क ् य ु आ र
क्युबा	क ् य ु ब ा
क्युबाको	क ् य ु ब ा क ो
क्युबेक	क ् य ु ब े क
क्युबेकको	क ् य ु ब े क क ो
क्युरायस	क ् य ु र ा य स
क्युरीको	क ् य ु र ी क ो
क्रम	क ् र म
क्रममा	क ् र म म ा
क्रमश	क ् र म श
क्रमिक	क ् र म ि क
क्रसओभर	क ् र स ओ भ र
क्राइ	क ् र ा इ
क्रान्ति	क ् र ा न ् त ि
क्रान्तिकारी	क ् र ा न ् त ि क ा र ी
क्रिकेट	क ् र ि क े ट
क्रिम	क ् र ि म
क्रिस	क ् र ि स
क्रिसले	क ् र ि स ल े
क्रीडाहरू	क ् र ी ड ा ह र ू
क्रुज	क ् र ु ज
क्रेइस	क ् र े इ स
क्रेइसमा	क ् र े इ स म ा
क्रेडिट	क ् र े ड ि ट
क्रोएसिया	क ् र ो ए स ि य ा
क्रोएसियाको	क ् र ो ए स ि य ा क ो
क्रोगरका	क ् र ो ग र क ा
क्रोनिक्लर	क ् र ो न ि क ् ल र
क्रोनिस्लर	क ् र ो न ि स ् ल र
क्लब	क ् ल ब
क्लबमा	क ् ल ब म ा
क्लस्टर	क ् ल स ् ट र
क्लारा	क ् ल ा र ा
क्लारामा	क ् ल ा र ा म ा
क्लिनिसियन	क ् ल ि न ि स ि य न
क्लेरिक	क ् ल े र ि क
क्लोराइडको	क ् ल ो र ा इ ड क ो
क्वाटर	क ् व ा ट र
क्वाराडग	क ् व ा र ा ड ग
क्वाला	क ् व ा ल ा
क्वीन्सल्यान्ड	क ् व ी न ् स ल ् य ा न ् ड
क्षमता	क ् ष म त ा
क्षमतामा	क ् ष म त ा म ा
क्षयरोग	क ् ष य र ो ग
क्षयरोगीहरूको	क ् ष य र ो ग ी ह र ू क ो
क्षेत्र	क ् ष े त ् र
क्षेत्रअन्तर्गत	क ् ष े त ् र अ न ् त र ् ग त
क्षेत्रका	क ् ष े त ् र क ा
क्षेत्रकी	क ् ष े त ् र क ी
क्षेत्रकै	क ् ष े त ् र क ै
क्षेत्रको	क ् ष े त ् र क ो
क्षेत्रपाटी	क ् ष े त ् र प ा ट ी
क्षेत्रफलको	क ् ष े त ् र फ ल क ो
क्षेत्रफलमा	क ् ष े त ् र फ ल म ा
क्षेत्रबाट	क ् ष े त ् र ब ा ट
क्षेत्रमा	क ् ष े त ् र म ा
क्षेत्रमै	क ् ष े त ् र म ै
क्षेत्रलाई	क ् ष े त ् र ल ा ई
क्षेत्रले	क ् ष े त ् र ल े
क्षेत्रहरू	क ् ष े त ् र ह र ू
क्षेत्रहरूमा	क ् ष े त ् र ह र ू म ा
क्षेत्रीय	क ् ष े त ् र ी य
ख	ख
खगोलीय	ख ग ो ल ी य
खचाखच	ख च ा ख च
खटजात्राक्रममा	ख ट ज ा त ् र ा क ् र म म ा
खटलाई	ख ट ल ा ई
खटिएका	ख ट ि ए क ा
खडायतको	ख ड ा य त क ो
खडेरीमा	ख ड े र ी म ा
खड्का	ख ड ् क ा
खड्काको	ख ड ् क ा क ो
खड्काले	ख ड ् क ा ल े
खण्ड	ख ण ् ड
खण्डमा	ख ण ् ड म ा
खत्रीको	ख त ् र ी क ो
खनिखोल	ख न ि ख ो ल
खनिज	ख न ि ज
खनिजको	ख न ि ज क ो
खपत	ख प त
खपिन्छेँ	ख प ि न ् छ े ँ
खपिन्छें	ख प ि न ् छ े ं
खप्तड	ख प ् त ड
खबर	ख ब र
खरायो	ख र ा य ो
खरिदका	ख र ि द क ा
खर्च	ख र ् च
खर्चिनु	ख र ् च ि न ु
खसाल्नको	ख स ा ल ् न क ो
खस्कियो	ख स ् क ि य ो
खस्रो	ख स ् र ो
खाँदबारी	ख ा ँ द ब ा र ी
खाँदा	ख ा ँ द ा
खाएर	ख ा ए र
खाकीको	ख ा क ी क ो
खाडीमा	ख ा ड ी म ा
खाद्यान्नहरू	ख ा द ् य ा न ् न ह र ू
खान	ख ा न
खानपिनमा	ख ा न प ि न म ा
खाना	ख ा न ा
खानु	ख ा न ु
खानुपर्छ	ख ा न ु प र ् छ
खानेकुरा	ख ा न े क ु र ा
खानेपानी	ख ा न े प ा न ी
खानेपानीको	ख ा न े प ा न ी क ो
खान्छन्	ख ा न ् छ न ्
खान्छु	ख ा न ् छ ु
खालको	ख ा ल क ो
खाले	ख ा ल े
खाल्का	ख ा ल ् क ा
खाल्डोको	ख ा ल ् ड ो क ो
खाल्डोमा	ख ा ल ् ड ो म ा
खासगरी	ख ा स ग र ी
खास्टे	ख ा स ् ट े
खिलाफतको	ख ि ल ा फ त क ो
खुङ्खार	ख ु ङ ् ख ा र
खुफिया	ख ु फ ि य ा
खुबै	ख ु ब ै
खुम्जुङ्ग	ख ु म ् ज ु ङ ् ग
खुम्बु	ख ु म ् ब ु
खुला	ख ु ल ा
खुलासा	ख ु ल ा स ा
खुलेको	ख ु ल े क ो
खुल्न	ख ु ल ् न
खुल्नु	ख ु ल ् न ु
खुल्ने	ख ु ल ् न े
खुवाउने	ख ु व ा उ न े
खुसी	ख ु स ी
खेतका	ख े त क ा
खेती	ख े त ी
खेप्न	ख े प ् न
खेल	ख े ल
खेलकुद	ख े ल क ु द
खेलकुदद्वारा	ख े ल क ु द द ् व ा र ा
खेलको	ख े ल क ो
खेलमा	ख े ल म ा
खेलहरूका	ख े ल ह र ू क ा
खेलाडी	ख े ल ा ड ी
खेलाडीको	ख े ल ा ड ी क ो
खेलिएको	ख े ल ि ए क ो
खेलेका	ख े ल े क ा
खेलेको	ख े ल े क ो
खेलौना	ख े ल ौ न ा
खेल्थे	ख े ल ् थ े
खेल्नका	ख े ल ् न क ा
खेल्ने	ख े ल ् न े
खैराना	ख ै र ा न ा
खोँच	ख ो ँ च
खोजिरहेको	ख ो ज ि र ह े क ो
खोजेको	ख ो ज े क ो
खोज्दा	ख ो ज ् द ा
खोज्दै	ख ो ज ् द ै
खोटाङ	ख ो ट ा ङ
खोप	ख ो प
खोला	ख ो ल ा
खोलाको	ख ो ल ा क ो
खोलामा	ख ो ल ा म ा
खोलाहरूको	ख ो ल ा ह र ू क ो
खोलिएको	ख ो ल ि ए क ो
खोलेका	ख ो ल े क ा
खोलेको	ख ो ल े क ो
खोल्ने	ख ो ल ् न े
ख्याति	ख ् य ा त ि
गंगाचील	ग ं ग ा च ी ल
गंगानगर	ग ं ग ा न ग र
गंगी	ग ं ग ी
गए	ग ए
गएका	ग ए क ा
गएको	ग ए क ो
गएर	ग ए र
गङ्गा	ग ङ ् ग ा
गङ्गाको	ग ङ ् ग ा क ो
गजल	ग ज ल
गडफादर	ग ड फ ा द र
गण	ग ण
गणको	ग ण क ो
गणतन्त्र	ग ण त न ् त ् र
गणतन्त्रका	ग ण त न ् त ् र क ा
गणतन्त्रको	ग ण त न ् त ् र क ो
गणतन्त्रद्वारा	ग ण त न ् त ् र द ् व ा र ा
गणतन्त्रमा	ग ण त न ् त ् र म ा
गणना	ग ण न ा
गणित	ग ण ि त
गणितज्ञ	ग ण ि त ज ् ञ
गणितीय	ग ण ि त ी य
गणेश	ग ण े श
गणेशबहादुर	ग ण े श ब ह ा द ु र
गण्डकी	ग ण ् ड क ी
गण्डगी	ग ण ् ड ग ी
गत	ग त
गति	ग त ि
गते	ग त े
गतेका	ग त े क ा
गतेबाट	ग त े ब ा ट
गतेसम्म	ग त े स म ् म
गनिन्छ	ग न ि न ् छ
गन्तब्य	ग न ् त ब ् य
गन्धर्व	ग न ् ध र ् व
गन्धर्वको	ग न ् ध र ् व क ो
गमन	ग म न
गम्भीर	ग म ् भ ी र
गराइयो	ग र ा इ य ो
गराउँदै	ग र ा उ ँ द ै
गराउनु	ग र ा उ न ु
गराउने	ग र ा उ न े
गराएपछि	ग र ा ए प छ ि
गरिँदै	ग र ि ँ द ै
गरिएका	ग र ि ए क ा
गरिएको	ग र ि ए क ो
गरिएकोले	ग र ि ए क ो ल े
गरिनु	ग र ि न ु
गरिने	ग र ि न े
गरिन्छ	ग र ि न ् छ
गरिन्छन्	ग र ि न ् छ न ्
गरिन्थ्यो	ग र ि न ् थ ् य ो
गरिब	ग र ि ब
गरियो	ग र ि य ो
गरिरहे	ग र ि र ह े
गरिरहेको	ग र ि र ह े क ो
गरिसकेपछि	ग र ि स क े प छ ि
गरिसक्नुभएको	ग र ि स क ् न ु भ ए क ो
गरी	ग र ी
गरीमाइक्रोसफ्टको	ग र ी म ा इ क ् र ो स फ ् ट क ो
गरुड	ग र ु ड
गरे	ग र े
गरेँ	ग र े ँ
गरेका	ग र े क ा
गरेको	ग र े क ो
गर्	ग र ्
गर्छ	ग र ् छ
गर्छन्	ग र ् छ न ्
गर्थेँ	ग र ् थ े ँ
गर्दछ	ग र ् द छ
गर्दछन्	ग र ् द छ न ्
गर्दछौँ	ग र ् द छ ौ ँ
गर्दथे	ग र ् द थ े
गर्दथ्यो	ग र ् द थ ् य ो
गर्दा	ग र ् द ा
गर्दे	ग र ् द े
गर्दै	ग र ् द ै
गर्न	ग र ् न
गर्नमा	ग र ् न म ा
गर्नु	ग र ् न ु
गर्नुअघि	ग र ् न ु अ घ ि
गर्नुपर्छ	ग र ् न ु प र ् छ
गर्नुपर्ने	ग र ् न ु प र ् न े
गर्नुपर्नेमा	ग र ् न ु प र ् न े म ा
गर्नुभएको	ग र ् न ु भ ए क ो
गर्नुभयो	ग र ् न ु भ य ो
गर्नुहोस्	ग र ् न ु ह ो स ्
गर्ने	ग र ् न े
गर्नेले	ग र ् न े ल े
गर्नेै	ग र ् न े ै
गर्भिणी	ग र ् भ ि ण ी
गर्ल्स	ग र ् ल ् स
गल्छी	ग ल ् छ ी
गहन	ग ह न
गहनामा	ग ह न ा म ा
गहिरीधारामा	ग ह ि र ी ध ा र ा म ा
गहिरो	ग ह ि र ो
गाँउ	ग ा ँ उ
गाईघाट	ग ा ई घ ा ट
गाईघाटमा	ग ा ई घ ा ट म ा
गाउँ	ग ा उ ँ
गाउँका	ग ा उ ँ क ा
गाउँको	ग ा उ ँ क ो
गाउँबाटै	ग ा उ ँ ब ा ट ै
गाउँमा	ग ा उ ँ म ा
गाउँलाई	ग ा उ ँ ल ा ई
गाउँहरूमा	ग ा उ ँ ह र ू म ा
गाउन	ग ा उ न
गाएका	ग ा ए क ा
गाएकी	ग ा ए क ी
गाएको	ग ा ए क ो
गाडीमा	ग ा ड ी म ा
गाडीहरूको	ग ा ड ी ह र ू क ो
गान	ग ा न
गाभिए	ग ा भ ि ए
गाभिएको	ग ा भ ि ए क ो
गायक	ग ा य क
गायकको	ग ा य क क ो
गायकगीतकार	ग ा य क ग ी त क ा र
गायन	ग ा य न
गायनमा	ग ा य न म ा
गायिका	ग ा य ि क ा
गाली	ग ा ल ी
गालीका	ग ा ल ी क ा
गाविस	ग ा व ि स
गाविसको	ग ा व ि स क ो
गाविसमा	ग ा व ि स म ा
गाह्रो	ग ा ह ् र ो
गिती	ग ि त ी
गिरफ्तार	ग ि र फ ् त ा र
गिरिबाट	ग ि र ि ब ा ट
गिरी	ग ि र ी
गिरीलाई	ग ि र ी ल ा ई
गिर्जाघर	ग ि र ् ज ा घ र
गिलास	ग ि ल ा स
गीत	ग ी त
गीतका	ग ी त क ा
गीतकार	ग ी त क ा र
गीतमा	ग ी त म ा
गीतहरू	ग ी त ह र ू
गीति	ग ी त ि
गीती	ग ी त ी
गुँदे	ग ु ँ द े
गुगल	ग ु ग ल
गुगलको	ग ु ग ल क ो
गुजरात	ग ु ज र ा त
गुजरातस्थित	ग ु ज र ा त स ् थ ि त
गुठियारहरूले	ग ु ठ ि य ा र ह र ू ल े
गुठीका	ग ु ठ ी क ा
गुठीहरूले	ग ु ठ ी ह र ू ल े
गुणद्वारा	ग ु ण द ् व ा र ा
गुणस्तरका	ग ु ण स ् त र क ा
गुप्त	ग ु प ् त
गुप्तबास	ग ु प ् त ब ा स
गुमाउनुपरेको	ग ु म ा उ न ु प र े क ो
गुमाएकी	ग ु म ा ए क ी
गुमाएको	ग ु म ा ए क ो
गुराँस	ग ु र ा ँ स
गुरुङ	ग ु र ु ङ
गुरुङले	ग ु र ु ङ ल े
गुरुङ्ग	ग ु र ु ङ ् ग
गुरुयोजना	ग ु र ु य ो ज न ा
गुरूवाचार्यले	ग ु र ू व ा च ा र ् य ल े
गुलाबी	ग ु ल ा ब ी
गुल्मी	ग ु ल ् म ी
गुस्ताव	ग ु स ् त ा व
गृष्मकाल	ग ृ ष ् म क ा ल
गृह	ग ृ ह
गेट	ग े ट
गेटस्ले	ग े ट स ् ल े
गैँडाकोट	ग ै ँ ड ा क ो ट
गैँडाकोत	ग ै ँ ड ा क ो त
गैया	ग ै य ा
गैर	ग ै र
गैरेको	ग ै र े क ो
गोकर्ण	ग ो क र ् ण
गोकर्णेश्वर	ग ो क र ् ण े श ् व र
गोटाल्यान्ड	ग ो ट ा ल ् य ा न ् ड
गोटिहवा	ग ो ट ि ह व ा
गोदावरी	ग ो द ा व र ी
गोदावरीमा	ग ो द ा व र ी म ा
गोपलराम	ग ो प ल र ा म
गोपाल	ग ो प ा ल
गोपिसिंह	ग ो प ि स ि ं ह
गोफ	ग ो फ
गोरखबहादुर	ग ो र ख ब ह ा द ु र
गोरखा	ग ो र ख ा
गोरु	ग ो र ु
गोरुसिङे	ग ो र ु स ि ङ े
गोरुसिङ्गे	ग ो र ु स ि ङ ् ग े
गोर्खा	ग ो र ् ख ा
गोल	ग ो ल
गोलकिपर	ग ो ल क ि प र
गोल्छा	ग ो ल ् छ ा
गोल्ड	ग ो ल ् ड
गोल्डम्यान	ग ो ल ् ड म ् य ा न
गोवा	ग ो व ा
गोवालाई	ग ो व ा ल ा ई
गोविन्दराज	ग ो व ि न ् द र ा ज
गोसाइँकुण्ड	ग ो स ा इ ँ क ु ण ् ड
गौचनको	ग ौ च न क ो
गौतम	ग ौ त म
गौतमको	ग ौ त म क ो
गौरव	ग ौ र व
गौरी	ग ौ र ी
गौरीशंकर	ग ौ र ी श ं क र
ग्	ग ्
ग्यासरब्रम	ग ् य ा स र ब ् र म
ग्रन्थ	ग ् र न ् थ
ग्रन्थी	ग ् र न ् थ ी
ग्रन्थ्	ग ् र न ् थ ्
ग्रह	ग ् र ह
ग्रहको	ग ् र ह क ो
ग्रान्ड	ग ् र ा न ् ड
ग्राफिक	ग ् र ा फ ि क
ग्राफिक्सका	ग ् र ा फ ि क ् स क ा
ग्रामीण	ग ् र ा म ी ण
ग्राहकको	ग ् र ा ह क क ो
ग्राहकहरूमाझ	ग ् र ा ह क ह र ू म ा झ
ग्राहकहरूलाई	ग ् र ा ह क ह र ू ल ा ई
ग्राहम	ग ् र ा ह म
ग्रिक	ग ् र ि क
ग्रिडको	ग ् र ि ड क ो
ग्रिलको	ग ् र ि ल क ो
ग्रिल्ड	ग ् र ि ल ् ड
ग्रिसको	ग ् र ि स क ो
ग्रिसमा	ग ् र ि स म ा
ग्रीष्मकालीन	ग ् र ी ष ् म क ा ल ी न
ग्रीसको	ग ् र ी स क ो
ग्रुप	ग ् र ु प
ग्रुपले	ग ् र ु प ल े
ग्रेइज	ग ् र े इ ज
ग्रेइजको	ग ् र े इ ज क ो
ग्रेगको	ग ् र े ग क ो
ग्रेट	ग ् र े ट
ग्रेडेड	ग ् र े ड े ड
ग्लाइडहरू	ग ् ल ा इ ड ह र ू
ग्लिसाइल	ग ् ल ि स ा इ ल
ग्लेसियर	ग ् ल े स ि य र
ग्लोबल	ग ् ल ो ब ल
ग्वाङझाउ	ग ् व ा ङ झ ा उ
ग्वाली	ग ् व ा ल ी
घग्घर	घ ग ् घ र
घटक	घ ट क
घटना	घ ट न ा
घटनाहरू	घ ट न ा ह र ू
घटेको	घ ट े क ो
घडी	घ ड ी
घण्टी	घ ण ् ट ी
घनत्व	घ न त ् व
घनपोखरा	घ न प ो ख र ा
घनिष्ट	घ न ि ष ् ट
घन्टा	घ न ् ट ा
घन्टाको	घ न ् ट ा क ो
घर	घ र
घरआँगनसम्म	घ र आ ँ ग न स म ् म
घरको	घ र क ो
घरघरसम्म	घ र घ र स म ् म
घरजग्गा	घ र ज ग ् ग ा
घरतिर	घ र त ि र
घरधुरी	घ र ध ु र ी
घरमा	घ र म ा
घरहरू	घ र ह र ू
घरहरूको	घ र ह र ू क ो
घरेलु	घ र े ल ु
घाँटी	घ ा ँ ट ी
घाँटीको	घ ा ँ ट ी क ो
घाँसे	घ ा ँ स े
घाँसेफिस्टो	घ ा ँ स े फ ि स ् ट ो
घाइतेहरूलाई	घ ा इ त े ह र ू ल ा ई
घाउ	घ ा उ
घाट	घ ा ट
घाटहरू	घ ा ट ह र ू
घाम	घ ा म
घामबाट	घ ा म ब ा ट
घाममा	घ ा म म ा
घिमिरे	घ ि म ि र े
घिमिरेको	घ ि म ि र े क ो
घिमिरेद्वारा	घ ि म ि र े द ् व ा र ा
घुम्न	घ ु म ् न
घुम्ने	घ ु म ् न े
घुर्मी	घ ु र ् म ी
घेरिएको	घ े र ि ए क ो
घोचेको	घ ो च े क ो
घोडाघोडी	घ ो ड ा घ ो ड ी
घोषणा	घ ो ष ण ा
घ्याङ	घ ् य ा ङ
चक्का	च क ् क ा
चट्टान	च ट ् ट ा न
चढाइने	च ढ ा इ न े
चन्द	च न ् द
चन्द्र	च न ् द ् र
चन्द्रकान्त	च न ् द ् र क ा न ् त
चन्द्रबहादुर	च न ् द ् र ब ह ा द ु र
चन्द्रमा	च न ् द ् र म ा
चन्द्रमाहरू	च न ् द ् र म ा ह र ू
चन्द्रसिं	च न ् द ् र स ि ं
चमत्कारिक	च म त ् क ा र ि क
चमर	च म र
चमर्टिन	च म र ् ट ि न
चमर्टिनको	च म र ् ट ि न क ो
चरण	च र ण
चरणको	च र ण क ो
चरणमा	च र ण म ा
चरणीय	च र ण ी य
चरन	च र न
चरा	च र ा
चराको	च र ा क ो
चराहरूले	च र ा ह र ू ल े
चरित्र	च र ि त ् र
चर्च	च र ् च
चर्चका	च र ् च क ा
चर्चको	च र ् च क ो
चर्चा	च र ् च ा
चर्चामा	च र ् च ा म ा
चर्चित	च र ् च ि त
चलचित्र	च ल च ि त ् र
चलचित्रका	च ल च ि त ् र क ा
चलचित्रकी	च ल च ि त ् र क ी
चलचित्रमा	च ल च ि त ् र म ा
चलचित्रहरू	च ल च ि त ् र ह र ू
चलचित्रहरूको	च ल च ि त ् र ह र ू क ो
चलन	च ल न
चलनमा	च ल न म ा
चलाउँथे	च ल ा उ ँ थ े
चलाउन	च ल ा उ न
चलाउनु	च ल ा उ न ु
चलाएर	च ल ा ए र
चलिरहेका	च ल ि र ह े क ा
चलिरहेको	च ल ि र ह े क ो
चलेका	च ल े क ा
चलेको	च ल े क ो
चल्दै	च ल ् द ै
चल्यो	च ल ् य ो
चवन्न	च व न ् न
चवालिसौँ	च व ा ल ि स ौ ँ
चवालीसमा	च व ा ल ी स म ा
चस्मा	च स ् म ा
चाँचर	च ा ँ च र
चाँदनी	च ा ँ द न ी
चाँदबाग	च ा ँ द ब ा ग
चापको	च ा प क ो
चार	च ा र
चारको	च ा र क ो
चारजनालाई	च ा र ज न ा ल ा ई
चारवटा	च ा र व ट ा
चारैतर्फ	च ा र ै त र ् फ
चार्ज	च ा र ् ज
चार्टर	च ा र ् ट र
चार्टर्ड	च ा र ् ट र ् ड
चालक	च ा ल क
चालिस	च ा ल ि स
चालिसमा	च ा ल ि स म ा
चालीस	च ा ल ी स
चालेनन	च ा ल े न न
चासो	च ा स ो
चाहनुहुन्छ	च ा ह न ु ह ु न ् छ
चाहिने	च ा ह ि न े
चाहिन्छ	च ा ह ि न ् छ
चाहेजतिको	च ा ह े ज त ि क ो
चिकित्सक	च ि क ि त ् स क
चिकित्सा	च ि क ि त ् स ा
चिजबिजहरू	च ि ज ब ि ज ह र ू
चितवन	च ि त व न
चित्त	च ि त ् त
चित्र	च ि त ् र
चित्रकला	च ि त ् र क ल ा
चित्रकार	च ि त ् र क ा र
चित्रहरू	च ि त ् र ह र ू
चित्रांक	च ि त ् र ा ं क
चिना	च ि न ा
चिनिन्छ	च ि न ि न ् छ
चिनियाँ	च ि न ि य ा ँ
चिनेका	च ि न े क ा
चिनो	च ि न ो
चिप	च ि प
चिप्लेकीराको	च ि प ् ल े क ी र ा क ो
चिमेको	च ि म े क ो
चिरेर	च ि र े र
चिलले	च ि ल ल े
चिली	च ि ल ी
चिलीको	च ि ल ी क ो
चिलीमा	च ि ल ी म ा
चिलेली	च ि ल े ल ी
चिसो	च ि स ो
चिहान	च ि ह ा न
चिहानको	च ि ह ा न क ो
चीन	च ी न
चीनका	च ी न क ा
चीनको	च ी न क ो
चीनमा	च ी न म ा
चीनले	च ी न ल े
चुचुरा	च ु च ु र ा
चुचुरो	च ु च ु र ो
चुनाव	च ु न ा व
चुनावद्वारा	च ु न ा व द ् व ा र ा
चुनावमा	च ु न ा व म ा
चुनावहरूमा	च ु न ा व ह र ू म ा
चुनिनुभयो	च ु न ि न ु भ य ो
चुभास	च ु भ ा स
चुम्बकीय	च ु म ् ब क ी य
चुलेत्रो	च ु ल े त ् र ो
चेक	च े क
चेचेन	च े च े न
चेचेन्सद्वारा	च े च े न ् स द ् व ा र ा
चेज	च े ज
चेतबहादुर	च े त ब ह ा द ु र
चेन्नाइको	च े न ् न ा इ क ो
चेपाङ	च े प ा ङ
चेपे	च े प े
चेहेरे	च े ह े र े
चैनपुरमा	च ै न प ु र म ा
चोइहीलाई	च ो इ ह ी ल ा ई
चोट	च ो ट
चोला	च ो ल ा
चौँथो	च ौ ँ थ ो
चौतहत्तरमा	च ौ त ह त ् त र म ा
चौतीस	च ौ त ी स
चौध	च ौ ध
चौधरी	च ौ ध र ी
चौधौँ	च ौ ध ौ ँ
चौबाटोमा	च ौ ब ा ट ो म ा
चौबिस	च ौ ब ि स
चौबिसै	च ौ ब ि स ै
चौरसम्म	च ौ र स म ् म
चौरहत्तर	च ौ र ह त ् त र
चौरहत्तरको	च ौ र ह त ् त र क ो
चौरानब्बेमा	च ौ र ा न ब ् ब े म ा
चौरानब्बेमामा	च ौ र ा न ब ् ब े म ा म ा
चौरासीमा	च ौ र ा स ी म ा
चौसट्ठी	च ौ स ट ् ठ ी
चौसिरको	च ौ स ि र क ो
च्याउको	च ् य ा उ क ो
च्यापेर	च ् य ा प े र
च्याम्पियन	च ् य ा म ् प ि य न
च्याम्पियनसिप	च ् य ा म ् प ि य न स ि प
छ	छ
छको	छ क ो
छड	छ ड
छत्तीस	छ त ् त ी स
छन्	छ न ्
छपन्नमा	छ प न ् न म ा
छब्बिस	छ ब ् ब ि स
छब्बीस	छ ब ् ब ी स
छमा	छ म ा
छयत्तर	छ य त ् त र
छयत्तरमा	छ य त ् त र म ा
छयहत्तरमा	छ य ह त ् त र म ा
छयानब्बे	छ य ा न ब ् ब े
छयालिस	छ य ा ल ि स
छयालिसदेखि	छ य ा ल ि स द े ख ि
छयालिसौँ	छ य ा ल ि स ौ ँ
छरिएर	छ र ि ए र
छलफल	छ ल फ ल
छल्न	छ ल ् न
छवि	छ व ि
छहराको	छ ह र ा क ो
छात्र	छ ा त ् र
छात्रवृति	छ ा त ् र व ृ त ि
छाप	छ ा प
छापियो	छ ा प ि य ो
छापेको	छ ा प े क ो
छाम	छ ा म
छाल	छ ा ल
छाला	छ ा ल ा
छालाका	छ ा ल ा क ा
छिचलेर	छ ि च ल े र
छिचल्छ	छ ि च ल ् छ
छिटो	छ ि ट ो
छिन्	छ ि न ्
छिन्ताङ	छ ि न ् त ा ङ
छिन्नमस्ता	छ ि न ् न म स ् त ा
छिमेकी	छ ि म े क ी
छिर्छ	छ ि र ् छ
छिर्दछ	छ ि र ् द छ
छु	छ ु
छुटका	छ ु ट क ा
छुट्टीको	छ ु ट ् ट ी क ो
छुट्टै	छ ु ट ् ट ै
छुट्याउन	छ ु ट ् य ा उ न
छुट्याएको	छ ु ट ् य ा ए क ो
छुने	छ ु न े
छेउछेउमा	छ े उ छ े उ म ा
छेउमा	छ े उ म ा
छेड्ने	छ े ड ् न े
छेत्री	छ े त ् र ी
छेपारोको	छ े प ा र ो क ो
छैँसट्ठी	छ ै ँ स ट ् ठ ी
छैठौँ	छ ै ठ ौ ँ
छैन	छ ै न
छैनन्	छ ै न न ्
छैन्	छ ै न ्
छैसट्ठी	छ ै स ट ् ठ ी
छोटाछोटा	छ ो ट ा छ ो ट ा
छोटो	छ ो ट ो
छोडी	छ ो ड ी
छोडेको	छ ो ड े क ो
छोडेर	छ ो ड े र
छोड्नु	छ ो ड ् न ु
छोपिएको	छ ो प ि ए क ो
छोरा	छ ो र ा
छोरालाई	छ ो र ा ल ा ई
छोराले	छ ो र ा ल े
छोराहरूलाई	छ ो र ा ह र ू ल ा ई
छोरी	छ ो र ी
छौँ	छ ौ ँ
जग	ज ग
जगतका	ज ग त क ा
जगदिश	ज ग द ि श
जगदीशपुर	ज ग द ी श प ु र
जग्गा	ज ग ् ग ा
जङ्गलको	ज ङ ् ग ल क ो
जङ्गलमा	ज ङ ् ग ल म ा
जज	ज ज
जटिल	ज ट ि ल
जति	ज त ि
जनकपुर	ज न क प ु र
जनता	ज न त ा
जनताका	ज न त ा क ा
जनताको	ज न त ा क ो
जनतादल	ज न त ा द ल
जनतालाई	ज न त ा ल ा ई
जनताले	ज न त ा ल े
जननिर्वाचित	ज न न ि र ् व ा च ि त
जननेता	ज न न े त ा
जनरल	ज न र ल
जनविश्वास	ज न व ि श ् व ा स
जनशक्तिलाई	ज न श क ् त ि ल ा ई
जनसङ्ख्या	ज न स ङ ् ख ् य ा
जनसङ्ख्याको	ज न स ङ ् ख ् य ा क ो
जनसन	ज न स न
जनसनले	ज न स न ल े
जनसाधारणको	ज न स ा ध ा र ण क ो
जनसाधारणले	ज न स ा ध ा र ण ल े
जना	ज न ा
जनाइएको	ज न ा इ ए क ो
जनाउँछ	ज न ा उ ँ छ
जनाउन	ज न ा उ न
जनाउने	ज न ा उ न े
जनाएको	ज न ा ए क ो
जनाको	ज न ा क ो
जनाले	ज न ा ल े
जनावर	ज न ा व र
जनावरको	ज न ा व र क ो
जनावरहरू	ज न ा व र ह र ू
जनावरहरूको	ज न ा व र ह र ू क ो
जन्म	ज न ् म
जन्मँदा	ज न ् म ँ द ा
जन्मजात	ज न ् म ज ा त
जन्मिएका	ज न ् म ि ए क ा
जन्मिएकै	ज न ् म ि ए क ै
जन्मिनु	ज न ् म ि न ु
जन्मेका	ज न ् म े क ा
जफती	ज फ त ी
जब	ज ब
जबरजस्ती	ज ब र ज स ् त ी
जमाइकन	ज म ा इ क न
जमिन	ज म ि न
जमिनको	ज म ि न क ो
जमोट	ज म ो ट
जयभक्त	ज य भ क ् त
जयसवालले	ज य स व ा ल ल े
जरुरी	ज र ु र ी
जर्जमारियोलाई	ज र ् ज म ा र ि य ो ल ा ई
जर्जियामा	ज र ् ज ि य ा म ा
जर्मन	ज र ् म न
जर्मनका	ज र ् म न क ा
जर्मनी	ज र ् म न ी
जर्मनीको	ज र ् म न ी क ो
जर्मनीमा	ज र ् म न ी म ा
जर्सिबाट	ज र ् स ि ब ा ट
जल	ज ल
जलप	ज ल प
जलयातायातयोग्य	ज ल य ा त ा य ा त य ो ग ् य
जलविद्युत	ज ल व ि द ् य ु त
जलेश्वरको	ज ल े श ् व र क ो
जवान	ज व ा न
जसको	ज स क ो
जसमा	ज स म ा
जसलाई	ज स ल ा ई
जसले	ज स ल े
जसो	ज स ो
जस्टिन	ज स ् ट ि न
जस्ता	ज स ् त ा
जस्तै	ज स ् त ै
जस्तो	ज स ् त ो
जस्तोसुकै	ज स ् त ो स ु क ै
जहाँताहाँ	ज ह ा ँ त ा ह ा ँ
जहिले	ज ह ि ल े
जाकार्ता	ज ा क ा र ् त ा
जागिर	ज ा ग ि र
जाजरकोटको	ज ा ज र क ो ट क ो
जाडो	ज ा ड ो
जातको	ज ा त क ो
जाति	ज ा त ि
जातिका	ज ा त ि क ा
जातिको	ज ा त ि क ो
जातिले	ज ा त ि ल े
जातिहरू	ज ा त ि ह र ू
जातिहरूबाट	ज ा त ि ह र ू ब ा ट
जातीय	ज ा त ी य
जात्रा	ज ा त ् र ा
जात्राका	ज ा त ् र ा क ा
जात्राको	ज ा त ् र ा क ो
जात्रामा	ज ा त ् र ा म ा
जान	ज ा न
जानकारी	ज ा न क ा र ी
जानकारीमा	ज ा न क ा र ी म ा
जानकी	ज ा न क ी
जानिन्छ	ज ा न ि न ् छ
जानिफकार	ज ा न ि फ क ा र
जानियो	ज ा न ि य ो
जानु	ज ा न ु
जानुकादेवी	ज ा न ु क ा द े व ी
जानुहोस्	ज ा न ु ह ो स ्
जाने	ज ा न े
जान्छ	ज ा न ् छ
जान्छु	ज ा न ् छ ु
जान्दथे	ज ा न ् द थ े
जान्ने	ज ा न ् न े
जापान	ज ा प ा न
जापानको	ज ा प ा न क ो
जापानिज	ज ा प ा न ि ज
जापानी	ज ा प ा न ी
जाभा	ज ा भ ा
जाभामा	ज ा भ ा म ा
जामनेपानी	ज ा म न े प ा न ी
जारी	ज ा र ी
जावलाखेलमा	ज ा व ल ा ख े ल म ा
जिती	ज ि त ी
जितु	ज ि त ु
जितेको	ज ि त े क ो
जितेदास्तीको	ज ि त े द ा स ् त ी क ो
जिन	ज ि न
जिनस	ज ि न स
जिन्दगी	ज ि न ् द ग ी
जिन्दगीका	ज ि न ् द ग ी क ा
जिपी	ज ि प ी
जिब्रो	ज ि ब ् र ो
जिम्नास्ट्सलाई	ज ि म ् न ा स ् ट ् स ल ा ई
जिम्मा	ज ि म ् म ा
जियोभौतिकशास्त्री	ज ि य ो भ ौ त ि क श ा स ् त ् र ी
जिरोनाको	ज ि र ो न ा क ो
जिल्लमा	ज ि ल ् ल म ा
जिल्ला	ज ि ल ् ल ा
जिल्लाका	ज ि ल ् ल ा क ा
जिल्लाको	ज ि ल ् ल ा क ो
जिल्लाबाट	ज ि ल ् ल ा ब ा ट
जिल्लाभित्र	ज ि ल ् ल ा भ ि त ् र
जिल्लामा	ज ि ल ् ल ा म ा
जिल्लालाई	ज ि ल ् ल ा ल ा ई
जिल्लासँग	ज ि ल ् ल ा स ँ ग
जिल्लाहरू	ज ि ल ् ल ा ह र ू
जिल्लाहरूका	ज ि ल ् ल ा ह र ू क ा
जिल्लाहरूको	ज ि ल ् ल ा ह र ू क ो
जिल्लाहरूलाई	ज ि ल ् ल ा ह र ू ल ा ई
जिवाणुको	ज ि व ा ण ु क ो
जीनस	ज ी न स
जीवन	ज ी व न
जीवनका	ज ी व न क ा
जीवनयापनमा	ज ी व न य ा प न म ा
जीवनशैली	ज ी व न श ै ल ी
जीवनस्तरमा	ज ी व न स ् त र म ा
जीवनी	ज ी व न ी
जीवनीबाट	ज ी व न ी ब ा ट
जीवन्त	ज ी व न ् त
जीवाणु	ज ी व ा ण ु
जीवाणुका	ज ी व ा ण ु क ा
जीवाणुको	ज ी व ा ण ु क ो
जीवाणुलाई	ज ी व ा ण ु ल ा ई
जीसी	ज ी स ी
जुँगे	ज ु ँ ग े
जुको	ज ु क ो
जुत्तामा	ज ु त ् त ा म ा
जुन	ज ु न
जुमा	ज ु म ा
जुम्ला	ज ु म ् ल ा
जुरीको	ज ु र ी क ो
जुलाई	ज ु ल ा ई
जुलियन	ज ु ल ि य न
जे	ज े
जेजियाङ	ज े ज ि य ा ङ
जेट	ज े ट
जेनिथ	ज े न ि थ
जेनेभामा	ज े न े भ ा म ा
जेनेरल	ज े न े र ल
जेन्समा	ज े न ् स म ा
जेभियर्स	ज े भ ि य र ् स
जेम्स	ज े म ् स
जेरुसेलम	ज े र ु स े ल म
जेलुपा	ज े ल ु प ा
जेविका	ज े व ि क ा
जेष्ठमा	ज े ष ् ठ म ा
जेहेन्दार	ज े ह े न ् द ा र
जैजान	ज ै ज ा न
जैन्सजुन	ज ै न ् स ज ु न
जैव	ज ै व
जो	ज ो
जोंग	ज ो ं ग
जोखर	ज ो ख र
जोगमाई	ज ो ग म ा ई
जोगाउन	ज ो ग ा उ न
जोङ	ज ो ङ
जोड	ज ो ड
जोडिएका	ज ो ड ि ए क ा
जोडिएको	ज ो ड ि ए क ो
जोडिने	ज ो ड ि न े
जोडेको	ज ो ड े क ो
जोड्दछ	ज ो ड ् द छ
जोड्ने	ज ो ड ् न े
जोन्जोन्दिङ	ज ो न ् ज ो न ् द ि ङ
जोमसोम	ज ो म स ो म
जोमसोमका	ज ो म स ो म क ा
जोललाई	ज ो ल ल ा ई
जोशी	ज ो श ी
जोशीको	ज ो श ी क ो
जोसेफ	ज ो स े फ
जोहान	ज ो ह ा न
जोहान्सबर्गमा	ज ो ह ा न ् स ब र ् ग म ा
जोहारीलको	ज ो ह ा र ी ल क ो
ज्ञवालीद्वारा	ज ् ञ व ा ल ी द ् व ा र ा
ज्ञान	ज ् ञ ा न
ज्ञानकुन्ज	ज ् ञ ा न क ु न ् ज
ज्ञानेन्द्र	ज ् ञ ा न े न ् द ् र
ज्याकेटमा	ज ् य ा क े ट म ा
ज्यादातर	ज ् य ा द ा त र
ज्यादै	ज ् य ा द ै
ज्यान	ज ् य ा न
ज्यार्दै	ज ् य ा र ् द ै
ज्योति	ज ् य ो त ि
ज्योतिषशास्त्रको	ज ् य ो त ि ष श ा स ् त ् र क ो
ज्योतिषीको	ज ् य ो त ि ष ी क ो
ज्वाँइ	ज ् व ा ँ इ
ज्वालामुखी	ज ् व ा ल ा म ु ख ी
झंकर	झ ं क र
झगडामा	झ ग ड ा म ा
झङ्कर	झ ङ ् क र
झण्डा	झ ण ् ड ा
झन	झ न
झन्डा	झ न ् ड ा
झयाडी	झ य ा ड ी
झरना	झ र न ा
झरनाभन्दा	झ र न ा भ न ् द ा
झरेको	झ र े क ो
झर्न	झ र ् न
झलकमान	झ ल क म ा न
झल्कने	झ ल ् क न े
झा	झ ा
झाडी	झ ा ड ी
झापा	झ ा प ा
झापाको	झ ा प ा क ो
झार	झ ा र
झिकिन्छ	झ ि क ि न ् छ
झैँ	झ ै ँ
झ्याप्सी	झ ् य ा प ् स ी
झ्याम्टे	झ ् य ा म ् ट े
ट	ट
टंकारलाई	ट ं क ा र ल ा ई
टर्की	ट र ् क ी
टर्कीको	ट र ् क ी क ो
टर्चका	ट र ् च क ा
टलिप	ट ल ि प
टस्क्यानीमा	ट स ् क ् य ा न ी म ा
टा	ट ा
टाँग्छन्	ट ा ँ ग ् छ न ्
टाँसिन्छ	ट ा ँ स ि न ् छ
टाइनो	ट ा इ न ो
टाइप	ट ा इ प
टाइम	ट ा इ म
टाइम्स	ट ा इ म ् स
टाइसन	ट ा इ स न
टाढा	ट ा ढ ा
टापु	ट ा प ु
टापुको	ट ा प ु क ो
टापुमा	ट ा प ु म ा
टार	ट ा र
टारकेरावारीको	ट ा र क े र ा व ा र ी क ो
टावर	ट ा व र
टावरभित्र	ट ा व र भ ि त ् र
टि	ट ि
टिआइएएसिआरइएफ	ट ि आ इ ए ए स ि आ र इ ए फ
टिकापुर	ट ि क ा प ु र
टिजेएक्स	ट ि ज े ए क ् स
टिभी	ट ि भ ी
टिम	ट ि म
टिमका	ट ि म क ा
टिस्	ट ि स ्
टिस्टा	ट ि स ् ट ा
टी	ट ी
टीम	ट ी म
टुर	ट ु र
टुरमा	ट ु र म ा
टुर्नामेन्टमा	ट ु र ् न ा म े न ् ट म ा
टेकबहादुर	ट े क ब ह ा द ु र
टेक्नोलोजिज	ट े क ् न ो ल ो ज ि ज
टेक्नोलोजी	ट े क ् न ो ल ो ज ी
टेक्नोलोजीज	ट े क ् न ो ल ो ज ी ज
टेक्नोलोजीबाट	ट े क ् न ो ल ो ज ी ब ा ट
टेक्सास	ट े क ् स ा स
टेनिस	ट े न ि स
टेबल	ट े ब ल
टेम्पलेट	ट े म ् प ल े ट
टेलर	ट े ल र
टेलरिङ्ग	ट े ल र ि ङ ् ग
टेलरिङ्गमा	ट े ल र ि ङ ् ग म ा
टेलिक	ट े ल ि क
टेलिकमको	ट े ल ि क म क ो
टेलिकमले	ट े ल ि क म ल े
टेलिफिल्म	ट े ल ि फ ि ल ् म
टेलिफोनको	ट े ल ि फ ो न क ो
टेलिभिजन	ट े ल ि भ ि ज न
टेलिभिजनमा	ट े ल ि भ ि ज न म ा
टेलिभिजनले	ट े ल ि भ ि ज न ल े
टेल्स	ट े ल ् स
टेसनरीलाई	ट े स न र ी ल ा ई
टोकियो	ट ो क ि य ो
टोकियोको	ट ो क ि य ो क ो
टोकियोमा	ट ो क ि य ो म ा
टोखा	ट ो ख ा
टोङा	ट ो ङ ा
टोनी	ट ो न ी
टोली	ट ो ल ी
टोलीका	ट ो ल ी क ा
टोलीले	ट ो ल ी ल े
टोस्ट	ट ो स ् ट
ट्याज्मानिया	ट ् य ा ज ् म ा न ि य ा
ट्याब्रिजमा	ट ् य ा ब ् र ि ज म ा
ट्युनर	ट ् य ु न र
ट्युबलर	ट ् य ु ब ल र
ट्युमुलसको	ट ् य ु म ु ल स क ो
ट्युलिट	ट ् य ु ल ि ट
ट्रउभर	ट ् र उ भ र
ट्रफी	ट ् र फ ी
ट्रभर	ट ् र भ र
ट्रयाक	ट ् र य ा क
ट्रस्टमा	ट ् र स ् ट म ा
ट्रान्जिट	ट ् र ा न ् ज ि ट
ट्रान्सफर	ट ् र ा न ् स फ र
ट्राफिक	ट ् र ा फ ि क
ट्रिक	ट ् र ि क
ट्रियमफल	ट ् र ि य म फ ल
ट्रियरमा	ट ् र ि य र म ा
ट्रुबेडर	ट ् र ु ब े ड र
ट्रुबेडरका	ट ् र ु ब े ड र क ा
ट्रेग	ट ् र े ग
ट्रेड	ट ् र े ड
ट्रेनमा	ट ् र े न म ा
ट्रेभिसोको	ट ् र े भ ि स ो क ो
ट्रेभिसोमा	ट ् र े भ ि स ो म ा
ट्रोउभर	ट ् र ो उ भ र
ट्र्याक	ट ् र ् य ा क
ट्वान्टी	ट ् व ा न ् ट ी
ट्वेन्टिफर्स्ट	ट ् व े न ् ट ि फ र ् स ् ट
ट्वेन्टिफोर	ट ् व े न ् ट ि फ ो र
ठकुरी	ठ क ु र ी
ठक्कर	ठ क ् क र
ठगी	ठ ग ी
ठगीने	ठ ग ी न े
ठगुन्नाको	ठ ग ु न ् न ा क ो
ठटालको	ठ ट ा ल क ो
ठट्यौली	ठ ट ् य ौ ल ी
ठप्प	ठ प ् प
ठमेल	ठ म े ल
ठहर	ठ ह र
ठाँउ	ठ ा ँ उ
ठाउँ	ठ ा उ ँ
ठाउँमा	ठ ा उ ँ म ा
ठाउँलाई	ठ ा उ ँ ल ा ई
ठाउँहरूको	ठ ा उ ँ ह र ू क ो
ठाउँहरूमध्ये	ठ ा उ ँ ह र ू म ध ् य े
ठिक्कदूरी	ठ ि क ् क द ू र ी
ठिमीस्थित	ठ ि म ी स ् थ ि त
ठुला	ठ ु ल ा
ठुलो	ठ ु ल ो
ठूल	ठ ू ल
ठूला	ठ ू ल ा
ठूली	ठ ू ल ी
ठूलो	ठ ू ल ो
ठोकर्पा	ठ ो क र ् प ा
ठोस	ठ ो स
डक	ड क
डच	ड च
डट	ड ट
डट्	ड ट ्
डडेलधुरा	ड ड े ल ध ु र ा
डबल	ड ब ल
डब्रोब्का	ड ब ् र ो ब ् क ा
डब्लिन	ड ब ् ल ि न
डम्बर	ड म ् ब र
डरहम	ड र ह म
डलर	ड ल र
डाँडाकाँडाले	ड ा ँ ड ा क ा ँ ड ा ल े
डाँडाहरू	ड ा ँ ड ा ह र ू
डाइङ्	ड ा इ ङ ्
डाक्ने	ड ा क ् न े
डाटा	ड ा ट ा
डानामिक्स	ड ा न ा म ि क ् स
डाभिड	ड ा भ ि ड
डायरीको	ड ा य र ी क ो
डायोसिज	ड ा य ो स ि ज
डालास	ड ा ल ा स
डाल्ले	ड ा ल ् ल े
डिएगोमा	ड ि ए ग ो म ा
डिग्रा	ड ि ग ् र ा
डिजाइन	ड ि ज ा इ न
डिजाइनका	ड ि ज ा इ न क ा
डिजाइनर	ड ि ज ा इ न र
डिजिट	ड ि ज ि ट
डिजिटल	ड ि ज ि ट ल
डिज्नी	ड ि ज ् न ी
डिपोमा	ड ि प ो म ा
डियरवाक	ड ि य र व ा क
डिरे	ड ि र े
डिरेकटिभीका	ड ि र े क ट ि भ ी क ा
डिल्लीराज	ड ि ल ् ल ी र ा ज
डिसी	ड ि स ी
डिसीको	ड ि स ी क ो
डिस्क	ड ि स ् क
डी	ड ी
डु	ड ु
डुङाको	ड ु ङ ा क ो
डुचीमा	ड ु च ी म ा
डुल्न	ड ु ल ् न
डे	ड े
डेकोरेसन	ड े क ो र े स न
डेटाबेस	ड े ट ा ब े स
डेनमार्क	ड े न म ा र ् क
डेनियल	ड े न ि य ल
डेनिस	ड े न ि स
डेभलपमेण्ट	ड े भ ल प म े ण ् ट
डेल्टा	ड े ल ् ट ा
डेल्टामा	ड े ल ् ट ा म ा
डोटी	ड ो ट ी
डोटीको	ड ो ट ी क ो
डोलाउने	ड ो ल ा उ न े
ड्अरमा	ड ् अ र म ा
ड्युरनमा	ड ् य ु र न म ा
ड्यूक	ड ् य ू क
ड्राइभ	ड ् र ा इ भ
ड्राफ्ट	ड ् र ा फ ् ट
ड्रेसर	ड ् र े स र
ड्रेसरमा	ड ् र े स र म ा
ढकाल	ढ क ा ल
ढकालको	ढ क ा ल क ो
ढङ्गबाट	ढ ङ ् ग ब ा ट
ढाँचा	ढ ा ँ च ा
ढाका	ढ ा क ा
ढाकी	ढ ा क ी
ढाकेको	ढ ा क े क ो
ढाडमा	ढ ा ड म ा
ढालिन्छ	ढ ा ल ि न ् छ
ढिस्कोमा	ढ ि स ् क ो म ा
ढुंगाना	ढ ु ं ग ा न ा
ढुङाको	ढ ु ङ ा क ो
ढुङ्गाना	ढ ु ङ ् ग ा न ा
ढुवानी	ढ ु व ा न ी
ढोँगहरू	ढ ो ँ ग ह र ू
ढोका	ढ ो क ा
तट	त ट
तटमा	त ट म ा
तटरेखा	त ट र े ख ा
तटीय	त ट ी य
तताउने	त त ा उ न े
तत्कालीन	त त ् क ा ल ी न
तत्पश्चात्	त त ् प श ् च ा त ्
तत्व	त त ् व
तथा	त थ ा
तथ्य	त थ ् य
तनहुँ	त न ह ु ँ
तनाव	त न ा व
तन्त्र	त न ् त ् र
तन्दुरीले	त न ् द ु र ी ल े
तपाईँ	त प ा ई ँ
तपाईँको	त प ा ई ँ क ो
तपाईँले	त प ा ई ँ ल े
तपाईँसामु	त प ा ई ँ स ा म ु
तपाईँहरूको	त प ा ई ँ ह र ू क ो
तब	त ब
तमिलकमको	त म ि ल क म क ो
तमोर	त म ो र
तम्घास	त म ् घ ा स
तय	त य
तयार	त य ा र
तयारी	त य ा र ी
तर	त र
तरकारीमा	त र क ा र ी म ा
तरङहरू	त र ङ ह र ू
तरिका	त र ि क ा
तरेपछि	त र े प छ ि
तर्क	त र ् क
तर्कहरूको	त र ् क ह र ू क ो
तर्फ	त र ् फ
तर्फबाट	त र ् फ ब ा ट
तल	त ल
तलछटमा	त ल छ ट म ा
तलब	त ल ब
तला	त ल ा
तलाई	त ल ा ई
तल्लो	त ल ् ल ो
तस्बिर	त स ् ब ि र
तहसम्म	त ह स म ् म
ता	त ा
ताइपेइ	त ा इ प े इ
ताइवानको	त ा इ व ा न क ो
ताका	त ा क ा
ताजा	त ा ज ा
तातो	त ा त ो
तानसेन	त ा न स े न
तापक्रमसँग	त ा प क ् र म स ँ ग
ताप्लेजुङ	त ा प ् ल े ज ु ङ
तामाको	त ा म ा क ो
तामोर	त ा म ो र
ताम्राकार	त ा म ् र ा क ा र
ताम्राकारको	त ा म ् र ा क ा र क ो
तायक	त ा य क
तारा	त ा र ा
ताराको	त ा र ा क ो
तारादेवी	त ा र ा द े व ी
तारानाथ	त ा र ा न ा थ
ताराहरू	त ा र ा ह र ू
ताराहरूको	त ा र ा ह र ू क ो
तारेख	त ा र े ख
ताल	त ा ल
तालको	त ा ल क ो
तालबाट	त ा ल ब ा ट
तालभन्दा	त ा ल भ न ् द ा
तालमध्ये	त ा ल म ध ् य े
तालमाघी	त ा ल म ा घ ी
तालमेल	त ा ल म े ल
तालहरू	त ा ल ह र ू
तालहरूमध्येको	त ा ल ह र ू म ध ् य े क ो
तालिम	त ा ल ि म
तिघ्राको	त ि घ ् र ा क ो
तिथि	त ि थ ि
तिन	त ि न
तिनका	त ि न क ा
तिनको	त ि न क ो
तिनलाई	त ि न ल ा ई
तिनाउ	त ि न ा उ
तिब्	त ि ब ्
तिब्बत	त ि ब ् ब त
तिब्बतको	त ि ब ् ब त क ो
तिब्बतमा	त ि ब ् ब त म ा
तिब्बतस्थित	त ि ब ् ब त स ् थ ि त
तिब्रीकोट	त ि ब ् र ी क ो ट
तिमिल्सिनाको	त ि म ि ल ् स ि न ा क ो
तिर	त ि र
तिरबाट	त ि र ब ा ट
तिल	त ि ल
तिलकसिंह	त ि ल क स ि ं ह
तिलगङ्गा	त ि ल ग ङ ् ग ा
तिलबाट	त ि ल ब ा ट
तिला	त ि ल ा
तिलिचो	त ि ल ि च ो
तिलोत्तमा	त ि ल ो त ् त म ा
तिस्	त ि स ्
तिहत्तर	त ि ह त ् त र
तिहारको	त ि ह ा र क ो
ती	त ी
तीन	त ी न
तीनएम	त ी न ए म
तीनको	त ी न क ो
तीनमै	त ी न म ै
तीनवटा	त ी न व ट ा
तीनै	त ी न ै
तीर्थ	त ी र ् थ
तीर्थबहादुर	त ी र ् थ ब ह ा द ु र
तीर्थाटन	त ी र ् थ ा ट न
तीव्र	त ी व ् र
तीस	त ी स
तीसको	त ी स क ो
तीसवर्षे	त ी स व र ् ष े
तुरुन्तै	त ु र ु न ् त ै
तुलना	त ु ल न ा
तुलसा	त ु ल स ा
तुलसी	त ु ल स ी
तुल्याएको	त ु ल ् य ा ए क ो
तुहरूको	त ु ह र ू क ो
तृतीयको	त ृ त ी य क ो
तृप्ति	त ृ प ् त ि
तेइस	त े इ स
तेइसौँ	त े इ स ौ ँ
तेजबहादुर	त े ज ब ह ा द ु र
तेत्तीसौँ	त े त ् त ी स ौ ँ
तेन्जिङ	त े न ् ज ि ङ
तेल	त े ल
तेश्रो	त े श ् र ो
तेस्रो	त े स ् र ो
तेहिसमा	त े ह ि स म ा
तेह्र	त े ह ् र
तेह्रको	त े ह ् र क ो
तेह्रथुम	त े ह ् र थ ु म
तेह्रवटा	त े ह ् र व ट ा
तेह्रौँ	त े ह ् र ौ ँ
तैपनि	त ै प न ि
तोड्न	त ो ड ् न
तोड्ने	त ो ड ् न े
तोड्यो	त ो ड ् य ो
त्यति	त ् य त ि
त्यतिकै	त ् य त ि क ै
त्यतिबेला	त ् य त ि ब े ल ा
त्यतिबेलासम्म	त ् य त ि ब े ल ा स म ् म
त्यत्तिकै	त ् य त ् त ि क ै
त्यस	त ् य स
त्यसअघि	त ् य स अ घ ि
त्यसको	त ् य स क ो
त्यसक्षेत्रका	त ् य स क ् ष े त ् र क ा
त्यसताका	त ् य स त ा क ा
त्यसपछि	त ् य स प छ ि
त्यसपछिका	त ् य स प छ ि क ा
त्यसबीच	त ् य स ब ी च
त्यसबेला	त ् य स ब े ल ा
त्यसमा	त ् य स म ा
त्यसै	त ् य स ै
त्यस्तै	त ् य स ् त ै
त्यहाँ	त ् य ह ा ँ
त्यहाँका	त ् य ह ा ँ क ा
त्यहाँबाट	त ् य ह ा ँ ब ा ट
त्यही	त ् य ह ी
त्यो	त ् य ो
त्योभन्दा	त ् य ो भ न ् द ा
त्रि	त ् र ि
त्रिचालिस	त ् र ि च ा ल ि स
त्रिचालिसौँ	त ् र ि च ा ल ि स ौ ँ
त्रिपन्नमा	त ् र ि प न ् न म ा
त्रिभुवन	त ् र ि भ ु व न
त्रियानब्बेमा	त ् र ि य ा न ब ् ब े म ा
त्रियासीको	त ् र ि य ा स ी क ो
त्रियुगा	त ् र ि य ु ग ा
त्रियोग	त ् र ि य ो ग
त्रिशुली	त ् र ि श ु ल ी
त्रिशूली	त ् र ि श ू ल ी
त्रिसट्ठी	त ् र ि स ट ् ठ ी
त्रिसट्ठीको	त ् र ि स ट ् ठ ी क ो
त्रिसट्ठीमा	त ् र ि स ट ् ठ ी म ा
त्रैमासिक	त ् र ै म ा स ि क
थप	थ प
थपिएको	थ प ि ए क ो
थम्थु	थ म ् थ ु
थरहरू	थ र ह र ू
थाइल्यान्ड	थ ा इ ल ् य ा न ् ड
थाइल्यान्डको	थ ा इ ल ् य ा न ् ड क ो
थानको	थ ा न क ो
थानीय	थ ा न ी य
थापा	थ ा प ा
थापाको	थ ा प ा क ो
थारूहरूको	थ ा र ू ह र ू क ो
थालनी	थ ा ल न ी
थालिएको	थ ा ल ि ए क ो
थाले	थ ा ल े
थालेका	थ ा ल े क ा
थालेको	थ ा ल े क ो
थाल्छ	थ ा ल ् छ
थाल्यो	थ ा ल ् य ो
थाहभएका	थ ा ह भ ए क ा
थाहा	थ ा ह ा
थिइनँ	थ ि इ न ँ
थिइन्	थ ि इ न ्
थिए	थ ि ए
थिएँ	थ ि ए ँ
थिएटरको	थ ि ए ट र क ो
थिएन	थ ि ए न
थिएनन्	थ ि ए न न ्
थियो	थ ि य ो
थियोरिस्ट	थ ि य ो र ि स ् ट
थुक्नु	थ ु क ् न ु
थुनिन्छ	थ ु न ि न ् छ
थुप्रै	थ ु प ् र ै
थुरिङियाको	थ ु र ि ङ ि य ा क ो
थोपर्ने	थ ो प र ् न े
थ्रि	थ ् र ि
थ्रिल्लर	थ ् र ि ल ् ल र
द	द
दई	द ई
दकोकाकोला	द क ो क ा क ो ल ा
दक्षिण	द क ् ष ि ण
दक्षिणको	द क ् ष ि ण क ो
दक्षिणकोरियाको	द क ् ष ि ण क ो र ि य ा क ो
दक्षिणतर्फ	द क ् ष ि ण त र ् फ
दक्षिणद्विप	द क ् ष ि ण द ् व ि प
दक्षिणपूर्वी	द क ् ष ि ण प ू र ् व ी
दक्षिणमा	द क ् ष ि ण म ा
दक्षिणी	द क ् ष ि ण ी
दगेस्तानमा	द ग े स ् त ा न म ा
दन्त	द न ् त
दमाईको	द म ा ई क ो
दम्पतीका	द म ् प त ी क ा
दया	द य ा
दयाहाङ	द य ा ह ा ङ
दरबार	द र ब ा र
दरबारको	द र ब ा र क ो
दरबारमा	द र ब ा र म ा
दरबारमार्गस्थित	द र ब ा र म ा र ् ग स ् थ ि त
दर्जनभन्दा	द र ् ज न भ न ् द ा
दर्ता	द र ् त ा
दर्शन	द र ् श न
दलाई	द ल ा ई
दशक	द श क
दशकअघि	द श क अ घ ि
दशरथ	द श र थ
दशैँ	द श ै ँ
दस	द स
दसको	द स क ो
दसमा	द स म ा
दसैँको	द स ै ँ क ो
दह	द ह
दहालको	द ह ा ल क ो
दाँजेर	द ा ँ ज े र
दाइ	द ा इ
दाइजो	द ा इ ज ो
दाङ	द ा ङ
दाङदेखी	द ा ङ द े ख ी
दाङमा	द ा ङ म ा
दाजुको	द ा ज ु क ो
दानबहादुर	द ा न ब ह ा द ु र
दाबी	द ा ब ी
दामोदर	द ा म ो द र
दाम्पत्य	द ा म ् प त ् य
दायाँ	द ा य ा ँ
दार्चुला	द ा र ् च ु ल ा
दार्जिलिङ	द ा र ् ज ि ल ि ङ
दार्जिलिङमा	द ा र ् ज ि ल ि ङ म ा
दार्जीलिङ्ग	द ा र ् ज ी ल ि ङ ् ग
दार्शनिक	द ा र ् श न ि क
दाहाल	द ा ह ा ल
दि	द ि
दिँदै	द ि ँ द ै
दिइयो	द ि इ य ो
दिए	द ि ए
दिएँ	द ि ए ँ
दिएका	द ि ए क ा
दिएकी	द ि ए क ी
दिएको	द ि ए क ो
दिएपछि	द ि ए प छ ि
दिन	द ि न
दिनका	द ि न क ा
दिनको	द ि न क ो
दिनदेखि	द ि न द े ख ि
दिनपछि	द ि न प छ ि
दिनबाट	द ि न ब ा ट
दिनमा	द ि न म ा
दिनु	द ि न ु
दिनुपर्ने	द ि न ु प र ् न े
दिनुभयो	द ि न ु भ य ो
दिनुहुन्छ	द ि न ु ह ु न ् छ
दिने	द ि न े
दिन्छ	द ि न ् छ
दिन्छन्	द ि न ् छ न ्
दिपक	द ि प क
दिपाङ	द ि प ा ङ
दिपायल	द ि प ा य ल
दिपायलमा	द ि प ा य ल म ा
दिपेन्द्र	द ि प े न ् द ् र
दिमित्री	द ि म ि त ् र ी
दिलीप	द ि ल ी प
दिल्लीलाई	द ि ल ् ल ी ल ा ई
दिवङ्गत	द ि व ङ ् ग त
दिव्यधाम	द ि व ् य ध ा म
दिशा	द ि श ा
दिशातिर	द ि श ा त ि र
दिसा	द ि स ा
दीक्षितद्वारा	द ी क ् ष ि त द ् व ा र ा
दीक्षितले	द ी क ् ष ि त ल े
दीपक	द ी प क
दीपा	द ी प ा
दीर्घ	द ी र ् घ
दीर्धराज	द ी र ् ध र ा ज
दुःख	द ु ः ख
दुःखलाग्दो	द ु ः ख ल ा ग ् द ो
दुइ	द ु इ
दुई	द ु ई
दुईको	द ु ई क ो
दुईटर्मिनल	द ु ई ट र ् म ि न ल
दुईटै	द ु ई ट ै
दुईमा	द ु ई म ा
दुईवटा	द ु ई व ट ा
दुधकोशी	द ु ध क ो श ी
दुनियाँमा	द ु न ि य ा ँ म ा
दुबाइ	द ु ब ा इ
दुराग्रह	द ु र ा ग ् र ह
दुरी	द ु र ी
दुरीमा	द ु र ी म ा
दुर्गा	द ु र ् ग ा
दुर्गादेवी	द ु र ् ग ा द े व ी
दुर्घटना	द ु र ् घ ट न ा
दुर्घटनाका	द ु र ् घ ट न ा क ा
दुलही	द ु ल ह ी
दुवै	द ु व ै
दुवैजना	द ु व ै ज न ा
दुवैले	द ु व ै ल े
दूधको	द ू ध क ो
दूरीको	द ू र ी क ो
दूरीमा	द ू र ी म ा
दृश्य	द ृ श ् य
दृष्टान्त	द ृ ष ् ट ा न ् त
दृष्टिमा	द ृ ष ् ट ि म ा
दृष्टिले	द ृ ष ् ट ि ल े
देउडा	द े उ ड ा
देउनिया	द े उ न ि य ा
देउमाई	द े उ म ा ई
देउराली	द े उ र ा ल ी
देखा	द े ख ा
देखाउँछन्	द े ख ा उ ँ छ न ्
देखाउने	द े ख ा उ न े
देखानुहोस्	द े ख ा न ु ह ो स ्
देखापरेका	द े ख ा प र े क ा
देखायो	द े ख ा य ो
देखि	द े ख ि
देखिएको	द े ख ि ए क ो
देखिने	द े ख ि न े
देखिन्छ	द े ख ि न ् छ
देखिन्छन्	द े ख ि न ् छ न ्
देखे	द े ख े
देख्न	द े ख ् न
देबघाटबाट	द े ब घ ा ट ब ा ट
देबघाटमा	द े ब घ ा ट म ा
देवता	द े व त ा
देवताहरूको	द े व त ा ह र ू क ो
देवराज	द े व र ा ज
देवलहरूमा	द े व ल ह र ू म ा
देवी	द े व ी
देवीको	द े व ी क ो
देवीदेवतालाई	द े व ी द े व त ा ल ा ई
देश	द े श
देशका	द े श क ा
देशकै	द े श क ै
देशको	द े श क ो
देशभरि	द े श भ र ि
देशमा	द े श म ा
देशमाको	द े श म ा क ो
देशहरूका	द े श ह र ू क ा
देशी	द े श ी
दैनिक	द ै न ि क
दैलेख	द ै ल े ख
दैव	द ै व
दैवीप्रकोप	द ै व ी प ् र क ो प
दोभान	द ो भ ा न
दोलखा	द ो ल ख ा
दोश्रो	द ो श ् र ो
दोषपूर्ण	द ो ष प ू र ् ण
दोस्रो	द ो स ् र ो
दोहोरो	द ो ह ो र ो
दौड	द ौ ड
दौरान	द ौ र ा न
द्रविड	द ् र व ि ड
द्रौपदी	द ् र ौ प द ी
द्रौपदीलाई	द ् र ौ प द ी ल ा ई
द्वय	द ् व य
द्वारिकाज	द ् व ा र ि क ा ज
द्वितीय	द ् व ि त ी य
द्विप	द ् व ि प
द्विपको	द ् व ि प क ो
द्विपक्षीय	द ् व ि प क ् ष ी य
द्विपमा	द ् व ि प म ा
द्विपसमुह	द ् व ि प स म ु ह
धन	ध न
धनकुटा	ध न क ु ट ा
धनगढी	ध न ग ढ ी
धनधान्यदेखि	ध न ध ा न ् य द े ख ि
धनराज	ध न र ा ज
धनसम्पत्तीको	ध न स म ् प त ् त ी क ो
धना	ध न ा
धनीमानी	ध न ी म ा न ी
धनुधर	ध न ु ध र
धनुषा	ध न ु ष ा
धरान	ध र ा न
धरानमा	ध र ा न म ा
धरावासीद्वारा	ध र ा व ा स ी द ् व ा र ा
धरासायी	ध र ा स ा य ी
धर्नामा	ध र ् न ा म ा
धर्म	ध र ् म
धर्मका	ध र ् म क ा
धर्मग्रन्थहरूमा	ध र ् म ग ् र न ् थ ह र ू म ा
धर्मयुद्ध	ध र ् म य ु द ् ध
धर्मयुद्धको	ध र ् म य ु द ् ध क ो
धर्मराज	ध र ् म र ा ज
धर्मशास्त्री	ध र ् म श ा स ् त ् र ी
धर्मावलम्बीहरूको	ध र ् म ा व ल म ् ब ी ह र ू क ो
धवलागिरी	ध व ल ा ग ि र ी
धातु	ध ा त ु
धादिङको	ध ा द ि ङ क ो
धान	ध ा न
धानका	ध ा न क ा
धान्ने	ध ा न ् न े
धापाखेलमा	ध ा प ा ख े ल म ा
धामी	ध ा म ी
धामीको	ध ा म ी क ो
धारणा	ध ा र ण ा
धारावाहिक	ध ा र ा व ा ह ि क
धार्मिक	ध ा र ् म ि क
धालिसको	ध ा ल ि स क ो
धावक	ध ा व क
धुन	ध ु न
धुर्कोटसम्म	ध ु र ् क ो ट स म ् म
धूपी	ध ू प ी
धेरै	ध े र ै
धेरैको	ध े र ै क ो
धेरैमात्रामा	ध े र ै म ा त ् र ा म ा
धेरैलाई	ध े र ै ल ा ई
धेरैले	ध े र ै ल े
धोज	ध ो ज
धौलागिरी	ध ौ ल ा ग ि र ी
धौलागिरीदेखि	ध ौ ल ा ग ि र ी द े ख ि
ध्यान	ध ् य ा न
ध्रवमा	ध ् र व म ा
नक्षत्र	न क ् ष त ् र
नक्सलवादी	न क ् स ल व ा द ी
नक्सा	न क ् स ा
नक्साल	न क ् स ा ल
नक्सालको	न क ् स ा ल क ो
नक्सालस्थित	न क ् स ा ल स ् थ ि त
नखाई	न ख ा ई
नगर	न ग र
नगरको	न ग र क ो
नगरकोट	न ग र क ो ट
नगरपालिका	न ग र प ा ल ि क ा
नगरपालिकाका	न ग र प ा ल ि क ा क ा
नगरपालिकाको	न ग र प ा ल ि क ा क ो
नगरपालिकामा	न ग र प ा ल ि क ा म ा
नगरबासीहरूले	न ग र ब ा स ी ह र ू ल े
नगरमालर	न ग र म ा ल र
नगरर	न ग र र
नगराए	न ग र ा ए
नगरिकन	न ग र ि क न
नजिक	न ज ि क
नजिकबाट	न ज ि क ब ा ट
नजिकै	न ज ि क ै
नजिकैको	न ज ि क ै क ो
नजीकको	न ज ी क क ो
नथ	न थ
नदी	न द ी
नदीका	न द ी क ा
नदीको	न द ी क ो
नदीपारी	न द ी प ा र ी
नदीमध्ये	न द ी म ध ् य े
नदीमा	न द ी म ा
नदीलाई	न द ी ल ा ई
नदीले	न द ी ल े
नदीसँग	न द ी स ँ ग
नदीसम्म	न द ी स म ् म
नदीसम्मको	न द ी स म ् म क ो
नदीसम्मा	न द ी स म ् म ा
नदीहरू	न द ी ह र ू
नदीहरूमा	न द ी ह र ू म ा
नन	न न
नन्दकृष्ण	न न ् द क ृ ष ् ण
नन्दसिंह	न न ् द स ि ं ह
नन्दादेबीसम्म	न न ् द ा द े ब ी स म ् म
नन्दिता	न न ् द ि त ा
नपर्खेको	न प र ् ख े क ो
नपाएको	न प ा ए क ो
नबित्दै	न ब ि त ् द ै
नबिर्सिनुहोला	न ब ि र ् स ि न ु ह ो ल ा
नब्बे	न ब ् ब े
नब्बेमा	न ब ् ब े म ा
नभइ	न भ इ
नभई	न भ ई
नभए	न भ ए
नभएका	न भ ए क ा
नभएको	न भ ए क ो
नभएर	न भ ए र
नभर्रेमा	न भ र ् र े म ा
नभेम्बर	न भ े म ् ब र
नमस्के	न म स ् क े
नमारोस्	न म ा र ो स ्
नमिलेको	न म ि ल े क ो
नमुना	न म ु न ा
नमेटिने	न म े ट ि न े
नमो	न म ो
नमोबुद्ध	न म ो ब ु द ् ध
नम्बर	न म ् ब र
नम्बरको	न म ् ब र क ो
नम्रता	न म ् र त ा
नयाँ	न य ा ँ
नरहरिलाई	न र ह र ि ल ा ई
नरहेको	न र ह े क ो
नराखीकन	न र ा ख ी क न
नरेन्द्र	न र े न ् द ् र
नर्तक	न र ् त क
नर्मन	न र ् म न
नर्वेको	न र ् व े क ो
नर्वेजियन	न र ् व े ज ि य न
नर्वेजीयाली	न र ् व े ज ी य ा ल ी
नलिएकी	न ल ि ए क ी
नवनिर्मित	न व न ि र ् म ि त
नवलपरासी	न व ल प र ा स ी
नविल	न व ि ल
नवीन	न व ी न
नवीनतम	न व ी न त म
नवौँ	न व ौ ँ
नष्	न ष ्
नष्ट	न ष ् ट
नसकुन्जेल	न स क ु न ् ज े ल
नसक्दा	न स क ् द ा
नसुनेका	न स ु न े क ा
नहुँदा	न ह ु ँ द ा
नहुने	न ह ु न े
नाइन	न ा इ न
नाइभरमा	न ा इ भ र म ा
नाक	न ा क
नाका	न ा क ा
नाकाको	न ा क ा क ो
नागरिक	न ा ग र ि क
नाच	न ा च
नाचको	न ा च क ो
नाचघरमा	न ा च घ र म ा
नाचहरूभन्दा	न ा च ह र ू भ न ् द ा
नाच्ने	न ा च ् न े
नाटक	न ा ट क
नाटककार	न ा ट क क ा र
नाटकीय	न ा ट क ी य
नाट्य	न ा ट ् य
नाडकर	न ा ड क र
नातागोतालाई	न ा त ा ग ो त ा ल ा ई
नाम	न ा म
नामक	न ा म क
नामकरण	न ा म क र ण
नामका	न ा म क ा
नामको	न ा म क ो
नामकोइलीदेवी	न ा म क ो इ ल ी द े व ी
नामबाट	न ा म ब ा ट
नाममा	न ा म म ा
नामले	न ा म ल े
नामहरू	न ा म ह र ू
नामहरूले	न ा म ह र ू ल े
नामाङ्कित	न ा म ा ङ ् क ि त
नामुद	न ा म ु द
नामै	न ा म ै
नायक	न ा य क
नायकका	न ा य क क ा
नायकमध्ये	न ा य क म ध ् य े
नायब	न ा य ब
नायबी	न ा य ब ी
नायिका	न ा य ि क ा
नायिकाहरू	न ा य ि क ा ह र ू
नायिकाहरूको	न ा य ि क ा ह र ू क ो
नारा	न ा र ा
नारायण	न ा र ा य ण
नारायणगोपाल	न ा र ा य ण ग ो प ा ल
नारायणी	न ा र ा य ण ी
नार्गाजुन	न ा र ् ग ा ज ु न
नाविक	न ा व ि क
नासपाती	न ा स प ा त ी
नि	न ि
निःशुल्क	न ि ः श ु ल ् क
निकट	न ि क ट
निकाल्ने	न ि क ा ल ् न े
निकाल्यो	न ि क ा ल ् य ो
निकासको	न ि क ा स क ो
निकुञ्ज	न ि क ु ञ ् ज
निकुञ्जमा	न ि क ु ञ ् ज म ा
निकुन्ज	न ि क ु न ् ज
निकेतन	न ि क े त न
निकै	न ि क ै
निगमका	न ि ग म क ा
निजी	न ि ज ी
निदानको	न ि द ा न क ो
निधन	न ि ध न
निधनपछि	न ि ध न प छ ि
निधनमा	न ि ध न म ा
निबन्ध	न ि ब न ् ध
निभाएको	न ि भ ा ए क ो
निमन्त्रण	न ि म न ् त ् र ण
निमन्त्रणा	न ि म न ् त ् र ण ा
निमराज	न ि म र ा ज
निमार्ता	न ि म ा र ् त ा
निमित्त	न ि म ि त ् त
निमिस	न ि म ि स
निमोउर्स	न ि म ो उ र ् स
निम्ति	न ि म ् त ि
नियन्त्रण	न ि य न ् त ् र ण
नियुक्त	न ि य ु क ् त
नियोग	न ि य ो ग
निरज	न ि र ज
निरन्तर	न ि र न ् त र
निरन्तरता	न ि र न ् त र त ा
निरुता	न ि र ु त ा
निरोधक	न ि र ो ध क
निरौला	न ि र ौ ल ा
निर्णय	न ि र ् ण य
निर्णयात्मक	न ि र ् ण य ा त ् म क
निर्देशक	न ि र ् द े श क
निर्देशकले	न ि र ् द े श क ल े
निर्देशन	न ि र ् द े श न
निर्देशनमा	न ि र ् द े श न म ा
निर्देशित	न ि र ् द े श ि त
निर्धारण	न ि र ् ध ा र ण
निर्धारित	न ि र ् ध ा र ि त
निर्मला	न ि र ् म ल ा
निर्माण	न ि र ् म ा ण
निर्माणका	न ि र ् म ा ण क ा
निर्माणको	न ि र ् म ा ण क ो
निर्माता	न ि र ् म ा त ा
निर्मित	न ि र ् म ि त
निर्मूल	न ि र ् म ू ल
निर्यात	न ि र ् य ा त
निर्वाचक	न ि र ् व ा च क
निर्वाचकगण	न ि र ् व ा च क ग ण
निर्वाचन	न ि र ् व ा च न
निर्वाचनबाट	न ि र ् व ा च न ब ा ट
निर्वाचनमा	न ि र ् व ा च न म ा
निर्वाचित	न ि र ् व ा च ि त
निर्वासन	न ि र ् व ा स न
निर्विरोध	न ि र ् व ि र ो ध
निर्स	न ि र ् स
निलिशाला	न ि ल ि श ा ल ा
निलिशालाबाट	न ि ल ि श ा ल ा ब ा ट
निवारण	न ि व ा र ण
निवेदन	न ि व े द न
निशा	न ि श ा
निशान	न ि श ा न
निशानको	न ि श ा न क ो
निश्चित	न ि श ् च ि त
निष्क्रिय	न ि ष ् क ् र ि य
निसाचरहरूलाई	न ि स ा च र ह र ू ल ा ई
निस्कने	न ि स ् क न े
निस्केको	न ि स ् क े क ो
निहित	न ि ह ि त
नीति	न ी त ि
नीमा	न ी म ा
नीर	न ी र
नीलु	न ी ल ु
नुआकाटा	न ु आ क ा ट ा
नुनिलो	न ु न ि ल ो
नुवाकोट	न ु व ा क ो ट
नुहाएमा	न ु ह ा ए म ा
नुहुन्छ	न ु ह ु न ् छ
नृत्य	न ृ त ् य
नृत्यलाई	न ृ त ् य ल ा ई
नृप	न ृ प
नेकपा	न े क प ा
नेचर	न े च र
नेटवर्क	न े ट व र ् क
नेता	न े त ा
नेताका	न े त ा क ा
नेताको	न े त ा क ो
नेताले	न े त ा ल े
नेदरल्यान्डको	न े द र ल ् य ा न ् ड क ो
नेदरल्यान्ड्सको	न े द र ल ् य ा न ् ड ् स क ो
नेपाल	न े प ा ल
नेपालका	न े प ा ल क ा
नेपालकै	न े प ा ल क ै
नेपालको	न े प ा ल क ो
नेपालगंज	न े प ा ल ग ं ज
नेपालगञ्जसम्म	न े प ा ल ग ञ ् ज स म ् म
नेपालबाट	न े प ा ल ब ा ट
नेपालमा	न े प ा ल म ा
नेपाललाई	न े प ा ल ल ा ई
नेपालले	न े प ा ल ल े
नेपाली	न े प ा ल ी
नेपालीका	न े प ा ल ी क ा
नेपालीको	न े प ा ल ी क ो
नेपासफ्ट	न े प ा स फ ् ट
नेप्च्युन	न े प ् च ् य ु न
नेभिमा	न े भ ि म ा
नेभी	न े भ ी
नेसनल	न े स न ल
नेसनवाइड	न े स न व ा इ ड
नेस्टारी	न े स ् ट ा र ी
नै	न ै
नैतिक	न ै त ि क
नैतिकतावादी	न ै त ि क त ा व ा द ी
नैतिकथाहरूको	न ै त ि क थ ा ह र ू क ो
नोट	न ो ट
नोटमा	न ो ट म ा
नोभा	न ो भ ा
नोभेम्बर	न ो भ े म ् ब र
नौ	न ौ
नौका	न ौ क ा
नौको	न ौ क ो
नौदेखि	न ौ द े ख ि
नौमा	न ौ म ा
नौसैनिक	न ौ स ै न ि क
न्	न ्
न्यायका	न ् य ा य क ा
न्यायपालिकामा	न ् य ा य प ा ल ि क ा म ा
न्यायाधीसहरूको	न ् य ा य ा ध ी स ह र ू क ो
न्यु	न ् य ु
न्युगिनी	न ् य ु ग ि न ी
न्युजिल्यान्ड	न ् य ु ज ि ल ् य ा न ् ड
न्युजिल्यान्डको	न ् य ु ज ि ल ् य ा न ् ड क ो
न्युजील्यान्ड	न ् य ु ज ी ल ् य ा न ् ड
न्युट्रोनहरू	न ् य ु ट ् र ो न ह र ू
न्युफाउन्डल्यान्ड	न ् य ु फ ा उ न ् ड ल ् य ा न ् ड
न्युयोर्क	न ् य ु य ो र ् क
न्युरेनी	न ् य ु र े न ी
न्यू	न ् य ू
न्यूजील्यान्डको	न ् य ू ज ी ल ् य ा न ् ड क ो
न्यूट्रोन	न ् य ू ट ् र ो न
न्यून	न ् य ू न
न्यूनरूपमा	न ् य ू न र ू प म ा
पंचतन्त्र	प ं च त न ् त ् र
पंचतन्त्रका	प ं च त न ् त ् र क ा
पकरइमामा	प क र इ म ा म ा
पक्राउ	प क ् र ा उ
पक्षसँग	प क ् ष स ँ ग
पक्षहरूको	प क ् ष ह र ू क ो
पखाल्न	प ख ा ल ् न
पगनाथ	प ग न ा थ
पङ्तिमा	प ङ ् त ि म ा
पचपन्नझ्याले	प च प न ् न झ ् य ा ल े
पचरौता	प च र ौ त ा
पचहत्तरमा	प च ह त ् त र म ा
पचहर्वा	प च ह र ् व ा
पचास	प च ा स
पचासी	प च ा स ी
पचासीको	प च ा स ी क ो
पचासौँ	प च ा स ौ ँ
पच्चपन्नमा	प च ् च प न ् न म ा
पच्चिस	प च ् च ि स
पच्चीस	प च ् च ी स
पछाडि	प छ ा ड ि
पछाडिको	प छ ा ड ि क ो
पछि	प छ ि
पछिल्लो	प छ ि ल ् ल ो
पछ्यौरी	प छ ् य ौ र ी
पछ्वारी	प छ ् व ा र ी
पजरकट्टी	प ज र क ट ् ट ी
पञ्चकन्या	प ञ ् च क न ् य ा
पञ्चकुला	प ञ ् च क ु ल ा
पञ्चकुले	प ञ ् च क ु ल े
पञ्चकुवा	प ञ ् च क ु व ा
पञ्चतन्त्र	प ञ ् च त न ् त ् र
पञ्चतन्त्रका	प ञ ् च त न ् त ् र क ा
पञ्चमी	प ञ ् च म ी
पञ्चैबाजाको	प ञ ् च ै ब ा ज ा क ो
पटक	प ट क
पटकथा	प ट क थ ा
पटकमै	प ट क म ै
पटना	प ट न ा
पटायामा	प ट ा य ा म ा
पटेल	प ट े ल
पठनीय	प ठ न ी य
पठाउन	प ठ ा उ न
पठार	प ठ ा र
पढाइ	प ढ ा इ
पढ्दै	प ढ ् द ै
पढ्ने	प ढ ् न े
पति	प त ि
पत्नी	प त ् न ी
पत्रकार	प त ् र क ा र
पत्रकारिता	प त ् र क ा र ि त ा
पत्रकारितामा	प त ् र क ा र ि त ा म ा
पत्रपत्रिका	प त ् र प त ् र ि क ा
पत्रिका	प त ् र ि क ा
पत्रिकाको	प त ् र ि क ा क ो
पदक	प द क
पदमबहादुर	प द म ब ह ा द ु र
पदस्थापना	प द स ् थ ा प न ा
पदार्थ	प द ा र ् थ
पदार्थहरूले	प द ा र ् थ ह र ू ल े
पदोन्नोती	प द ो न ् न ो त ी
पद्दति	प द ् द त ि
पद्धतिहरू	प द ् ध त ि ह र ू
पद्म	प द ् म
पद्मकन्या	प द ् म क न ् य ा
पनि	प न ि
पनेरुको	प न े र ु क ो
पनौती	प न ौ त ी
पन्चानब्बे	प न ् च ा न ब ् ब े
पन्त	प न ् त
पन्तका	प न ् त क ा
पन्तको	प न ् त क ो
पन्ध्र	प न ् ध ् र
पप	प प
पपुवा	प प ु व ा
पब्लिकेसनले	प ब ् ल ि क े स न ल े
परजीविहरू	प र ज ी व ि ह र ू
परदेशतिर	प र द े श त ि र
परमाणु	प र म ा ण ु
परम्परा	प र म ् प र ा
परम्पराअनुसार	प र म ् प र ा अ न ु स ा र
परम्परागत	प र म ् प र ा ग त
परम्परामा	प र म ् प र ा म ा
परस्पर	प र स ् प र
पराउने	प र ा उ न े
पराजित	प र ा ज ि त
परापूर्वकालबाटै	प र ा प ू र ् व क ा ल ब ा ट ै
परापूर्वकालीन	प र ा प ू र ् व क ा ल ी न
परालको	प र ा ल क ो
परिकार	प र ि क ा र
परिकारहरू	प र ि क ा र ह र ू
परिचय	प र ि च य
परिचालन	प र ि च ा ल न
परिणाम	प र ि ण ा म
परिपाटी	प र ि प ा ट ी
परिपूर्ण	प र ि प ू र ् ण
परिभाषित	प र ि भ ा ष ि त
परिमल	प र ि म ल
परिमाण	प र ि म ा ण
परिमार्जन	प र ि म ा र ् ज न
परियार	प र ि य ा र
परियारको	प र ि य ा र क ो
परियोजना	प र ि य ो ज न ा
परियोजनाको	प र ि य ो ज न ा क ो
परियोजनाहरू	प र ि य ो ज न ा ह र ू
परियोजनाहरूमध्ये	प र ि य ो ज न ा ह र ू म ध ् य े
परिवर्तन	प र ि व र ् त न
परिवर्तनको	प र ि व र ् त न क ो
परिवहन	प र ि व ह न
परिवार	प र ि व ा र
परिवारको	प र ि व ा र क ो
परिवारजन	प र ि व ा र ज न
परिवारमा	प र ि व ा र म ा
परिवारले	प र ि व ा र ल े
परिषद्ले	प र ि ष द ् ल े
परी	प र ी
परीक्षणका	प र ी क ् ष ण क ा
परेका	प र े क ा
परेकी	प र े क ी
परेको	प र े क ो
परेकोले	प र े क ो ल े
परेछ	प र े छ
परेवामध्ये	प र े व ा म ध ् य े
परोडि	प र ो ड ि
पर्	प र ्
पर्खाल	प र ् ख ा ल
पर्खालमा	प र ् ख ा ल म ा
पर्छ	प र ् छ
पर्छन	प र ् छ न
पर्दछ	प र ् द छ
पर्दछन	प र ् द छ न
पर्दछन्	प र ् द छ न ्
पर्दथ्यो	प र ् द थ ् य ो
पर्दा	प र ् द ा
पर्दामा	प र ् द ा म ा
पर्दैछन्	प र ् द ै छ न ्
पर्न	प र ् न
पर्नुभयो	प र ् न ु भ य ो
पर्ने	प र ् न े
पर्पल	प र ् प ल
पर्यटक	प र ् य ट क
पर्यटककै	प र ् य ट क क ै
पर्यटकको	प र ् य ट क क ो
पर्यटकमाझ	प र ् य ट क म ा झ
पर्यटकहरू	प र ् य ट क ह र ू
पर्यटकहरूको	प र ् य ट क ह र ू क ो
पर्यटकहरूमा	प र ् य ट क ह र ू म ा
पर्यटकहरूमाझ	प र ् य ट क ह र ू म ा झ
पर्यटकहरूलाई	प र ् य ट क ह र ू ल ा ई
पर्यटकहरूले	प र ् य ट क ह र ू ल े
पर्यटकिय	प र ् य ट क ि य
पर्यटकीय	प र ् य ट क ी य
पर्यटन	प र ् य ट न
पर्यटनको	प र ् य ट न क ो
पर्यटनले	प र ् य ट न ल े
पर्यावरण	प र ् य ा व र ण
पर्यावरणीय	प र ् य ा व र ण ी य
पर्व	प र ् व
पर्वत	प र ् व त
पर्वतमा	प र ् व त म ा
पर्वतमाला	प र ् व त म ा ल ा
पर्वतहरू	प र ् व त ह र ू
पर्वतीय	प र ् व त ी य
पर्सियाका	प र ् स ि य ा क ा
पलाउ	प ल ा उ
पलायन	प ल ा य न
पलिमर	प ल ि म र
पल्ट	प ल ् ट
पल्लो	प ल ् ल ो
पवित्र	प व ि त ् र
पशुपतिको	प श ु प त ि क ो
पशुशास्त्री	प श ु श ा स ् त ् र ी
पशुहरूको	प श ु ह र ू क ो
पश्चिम	प श ् च ि म
पश्चिमतर्फ	प श ् च ि म त र ् फ
पश्चिममा	प श ् च ि म म ा
पश्चिमा	प श ् च ि म ा
पश्चिमाञ्चल	प श ् च ि म ा ञ ् च ल
पश्चिमाञ्चलमा	प श ् च ि म ा ञ ् च ल म ा
पश्चिमी	प श ् च ि म ी
पश्चिमेली	प श ् च ि म े ल ी
पसल	प स ल
पसलका	प स ल क ा
पसलको	प स ल क ो
पसलबाट	प स ल ब ा ट
पसलमा	प स ल म ा
पसलले	प स ल ल े
पस्किइन्छ	प स ् क ि इ न ् छ
पहरामा	प ह र ा म ा
पहलमा	प ह ल म ा
पहाड	प ह ा ड
पहाडका	प ह ा ड क ा
पहाडमा	प ह ा ड म ा
पहाडी	प ह ा ड ी
पहिचान	प ह ि च ा न
पहिरन	प ह ि र न
पहिरनको	प ह ि र न क ो
पहिराका	प ह ि र ा क ा
पहिरो	प ह ि र ो
पहिरोका	प ह ि र ो क ा
पहिला	प ह ि ल ा
पहिले	प ह ि ल े
पहिलेदेखि	प ह ि ल े द े ख ि
पहिलो	प ह ि ल ो
पहिलोपटक	प ह ि ल ो प ट क
पाँच	प ा ँ च
पाँचथर	प ा ँ च थ र
पाँचमा	प ा ँ च म ा
पाँचसय	प ा ँ च स य
पाँचैवटा	प ा ँ च ै व ट ा
पाँचौँ	प ा ँ च ौ ँ
पाइँदैन	प ा इ ँ द ै न
पाइएको	प ा इ ए क ो
पाइड	प ा इ ड
पाइने	प ा इ न े
पाइनेछ	प ा इ न े छ
पाइनेभन्दा	प ा इ न े भ न ् द ा
पाइन्छ	प ा इ न ् छ
पाइन्छन्	प ा इ न ् छ न ्
पाइन्ट	प ा इ न ् ट
पाइन्न	प ा इ न ् न
पाइयो	प ा इ य ो
पाइरहेका	प ा इ र ह े क ा
पाइसकेको	प ा इ स क े क ो
पाउन	प ा उ न
पाउनुहुनेछ	प ा उ न ु ह ु न े छ
पाए	प ा ए
पाएमा	प ा ए म ा
पाकिस्तान	प ा क ि स ् त ा न
पाकिस्तानको	प ा क ि स ् त ा न क ो
पाकिस्तानमा	प ा क ि स ् त ा न म ा
पाखा	प ा ख ा
पाखाबाट	प ा ख ा ब ा ट
पाखाहरू	प ा ख ा ह र ू
पाखाहरूको	प ा ख ा ह र ू क ो
पाच	प ा च
पाटन	प ा ट न
पाटनले	प ा ट न ल े
पाठ	प ा ठ
पाठमा	प ा ठ म ा
पाण्डव	प ा ण ् ड व
पाण्डवमध्येका	प ा ण ् ड व म ध ् य े क ा
पाण्डवहरू	प ा ण ् ड व ह र ू
पातेमेला	प ा त े म े ल ा
पात्र	प ा त ् र
पात्रको	प ा त ् र क ो
पात्रलाई	प ा त ् र ल ा ई
पादन	प ा द न
पादरी	प ा द र ी
पानाहरू	प ा न ा ह र ू
पानी	प ा न ी
पानीको	प ा न ी क ो
पानीमा	प ा न ी म ा
पारखी	प ा र ख ी
पारखीहरूले	प ा र ख ी ह र ू ल े
पाररिसाएको	प ा र र ि स ा ए क ो
पारानाको	प ा र ा न ा क ो
पारासिटोइड	प ा र ा स ि ट ो इ ड
पारिए	प ा र ि ए
पारिएको	प ा र ि ए क ो
पारियो	प ा र ि य ो
पारिश्रमिक	प ा र ि श ् र म ि क
पारिस्थितिक	प ा र ि स ् थ ि त ि क
पारेर	प ा र े र
पार्क	प ा र ् क
पार्कमा	प ा र ् क म ा
पार्टनर्स	प ा र ् ट न र ् स
पार्टी	प ा र ् ट ी
पार्टीका	प ा र ् ट ी क ा
पार्टीको	प ा र ् ट ी क ो
पार्टीबाट	प ा र ् ट ी ब ा ट
पार्टीहरूका	प ा र ् ट ी ह र ू क ा
पार्न	प ा र ् न
पार्वतीको	प ा र ् व त ी क ो
पार्श्व	प ा र ् श ् व
पार्सल	प ा र ् स ल
पाल	प ा ल
पालन	प ा ल न
पालीका	प ा ल ी क ा
पालीको	प ा ल ी क ो
पाल्चोक	प ा ल ् च ो क
पाल्तु	प ा ल ् त ु
पाल्तू	प ा ल ् त ू
पास	प ा स
पाहुना	प ा ह ु न ा
पिएको	प ि ए क ो
पिटर	प ि ट र
पिटर्सबर्गमा	प ि ट र ् स ब र ् ग म ा
पिडमोन्टमा	प ि ड म ो न ् ट म ा
पिडित	प ि ड ि त
पिण्ड	प ि ण ् ड
पिपलकोट	प ि प ल क ो ट
पिपलकोटको	प ि प ल क ो ट क ो
पिपुल्स	प ि प ु ल ् स
पिफाइजरले	प ि फ ा इ ज र ल े
पिरेजमा	प ि र े ज म ा
पिरोलिरहन्थे	प ि र ो ल ि र ह न ् थ े
पिल्ग्रिम्स	प ि ल ् ग ् र ि म ् स
पिस	प ि स
पिसाव	प ि स ा व
पिसिबी	प ि स ि ब ी
पी	प ी
पीडा	प ी ड ा
पीडामा	प ी ड ा म ा
पीडित	प ी ड ि त
पीडितहरूको	प ी ड ि त ह र ू क ो
पीडितहरूलाई	प ी ड ि त ह र ू ल ा ई
पीप	प ी प
पीमा	प ी म ा
पीसा	प ी स ा
पुँजीवादमा	प ु ँ ज ी व ा द म ा
पुगिन्	प ु ग ि न ्
पुगेका	प ु ग े क ा
पुगेको	प ु ग े क ो
पुग्छ	प ु ग ् छ
पुग्छे	प ु ग ् छ े
पुग्दा	प ु ग ् द ा
पुग्न	प ु ग ् न
पुग्नुभएको	प ु ग ् न ु भ ए क ो
पुजा	प ु ज ा
पुजापाठ	प ु ज ा प ा ठ
पुजारीको	प ु ज ा र ी क ो
पुजारीद्वारा	प ु ज ा र ी द ् व ा र ा
पुनरुद्धार	प ु न र ु द ् ध ा र
पुनर्निर्मित	प ु न र ् न ि र ् म ि त
पुनर्मिलन	प ु न र ् म ि ल न
पुनर्स्थापित	प ु न र ् स ् थ ा प ि त
पुन्टा	प ु न ् ट ा
पुमोरी	प ु म ो र ी
पुरस्कार	प ु र स ् क ा र
पुरा	प ु र ा
पुराणमा	प ु र ा ण म ा
पुरातन	प ु र ा त न
पुरातात्विक	प ु र ा त ा त ् व ि क
पुराना	प ु र ा न ा
पुरानामध्ये	प ु र ा न ा म ध ् य े
पुरानो	प ु र ा न ो
पुरी	प ु र ी
पुरीका	प ु र ी क ा
पुरुष	प ु र ु ष
पुरुषलाई	प ु र ु ष ल ा ई
पुर्	प ु र ्
पुर्ख्यौली	प ु र ् ख ् य ौ ल ी
पुर्ने	प ु र ् न े
पुल	प ु ल
पुलहरूको	प ु ल ह र ू क ो
पुलिस	प ु ल ि स
पुवामाई	प ु व ा म ा ई
पुष्टि	प ु ष ् ट ि
पुष्प	प ु ष ् प
पुष्पलाल	प ु ष ् प ल ा ल
पुस्तक	प ु स ् त क
पुस्तकका	प ु स ् त क क ा
पुस्तकमा	प ु स ् त क म ा
पुस्तकहरू	प ु स ् त क ह र ू
पुस्तकहरूको	प ु स ् त क ह र ू क ो
पुस्तकहरूमा	प ु स ् त क ह र ू म ा
पुस्तकालय	प ु स ् त क ा ल य
पुस्तकालयका	प ु स ् त क ा ल य क ा
पुस्तकालयमा	प ु स ् त क ा ल य म ा
पुस्तकालयलाई	प ु स ् त क ा ल य ल ा ई
पुस्पा	प ु स ् प ा
पूजा	प ू ज ा
पूजाआजा	प ू ज ा आ ज ा
पूर्ण	प ू र ् ण
पूर्णकालीन	प ू र ् ण क ा ल ी न
पूर्णा	प ू र ् ण ा
पूर्णिमाको	प ू र ् ण ि म ा क ो
पूर्व	प ू र ् व
पूर्वअधिराजकुमारी	प ू र ् व अ ध ि र ा ज क ु म ा र ी
पूर्वका	प ू र ् व क ा
पूर्वतर्फ	प ू र ् व त र ् फ
पूर्वपट्टि	प ू र ् व प ट ् ट ि
पूर्वपत्नी	प ू र ् व प त ् न ी
पूर्वपश्चिम	प ू र ् व प श ् च ि म
पूर्वमन्त्री	प ू र ् व म न ् त ् र ी
पूर्वमा	प ू र ् व म ा
पूर्वाञ्चल	प ू र ् व ा ञ ् च ल
पूर्वाञ्चलका	प ू र ् व ा ञ ् च ल क ा
पूर्वाञ्चलको	प ू र ् व ा ञ ् च ल क ो
पूर्वी	प ू र ् व ी
पूर्वोत्तर	प ू र ् व ो त ् त र
पृथ्वी	प ृ थ ् व ी
पृथ्वीको	प ृ थ ् व ी क ो
पृथ्वीनगर	प ृ थ ् व ी न ग र
पृथ्वीनारायण	प ृ थ ् व ी न ा र ा य ण
पृष्ठ	प ृ ष ् ठ
पृष्ठभूमि	प ृ ष ् ठ भ ू म ि
पेक्दु	प े क ् द ु
पेट	प े ट
पेट्रा	प े ट ् र ा
पेट्रोल	प े ट ् र ो ल
पेट्रोलियमले	प े ट ् र ो ल ि य म ल े
पेन्गुइन	प े न ् ग ु इ न
पेपर	प े प र
पेप्सिको	प े प ् स ि क ो
पेय	प े य
पेरिसको	प े र ि स क ो
पेरुको	प े र ु क ो
पेसा	प े स ा
पेसाको	प े स ा क ो
पैतालिस	प ै त ा ल ि स
पैतालिसौँ	प ै त ा ल ि स ौ ँ
पैदल	प ै द ल
पैरबाँसा	प ै र ब ा ँ स ा
पैसट्ठी	प ै स ट ् ठ ी
पैसट्ठीमा	प ै स ट ् ठ ी म ा
पैसा	प ै स ा
पोकर	प ो क र
पोखरा	प ो ख र ा
पोखराको	प ो ख र ा क ो
पोखराबाट	प ो ख र ा ब ा ट
पोखरी	प ो ख र ी
पोखरीको	प ो ख र ी क ो
पोखरीमा	प ो ख र ी म ा
पोखरीहरू	प ो ख र ी ह र ू
पोखरेल	प ो ख र े ल
पोखरेलले	प ो ख र े ल ल े
पोन्ट	प ो न ् ट
पोप	प ो प
पोपिङ	प ो प ि ङ
पोर्चुगल	प ो र ् च ु ग ल
पोर्चुगलीहरूले	प ो र ् च ु ग ल ी ह र ू ल े
पोर्चुगाली	प ो र ् च ु ग ा ल ी
पोलिस	प ो ल ि स
पोलो	प ो ल ो
पोल्याण्डमा	प ो ल ् य ा ण ् ड म ा
पोल्यान्ड	प ो ल ् य ा न ् ड
पोल्यान्डको	प ो ल ् य ा न ् ड क ो
पोल्यान्डमा	प ो ल ् य ा न ् ड म ा
पोषण	प ो ष ण
पोस्टइम्प्रेसनिस्ट	प ो स ् ट इ म ् प ् र े स न ि स ् ट
पोस्टमा	प ो स ् ट म ा
पौडेलको	प ौ ड े ल क ो
पौरख	प ौ र ख
पौराणिक	प ौ र ा ण ि क
पौष	प ौ ष
प्याकेटहरू	प ् य ा क े ट ह र ू
प्याङ	प ् य ा ङ
प्याङका	प ् य ा ङ क ा
प्याङको	प ् य ा ङ क ो
प्याङमा	प ् य ा ङ म ा
प्यालाको	प ् य ा ल ा क ो
प्योङयाङ	प ् य ो ङ य ा ङ
प्रकट	प ् र क ट
प्रकरण	प ् र क र ण
प्रकार	प ् र क ा र
प्रकारका	प ् र क ा र क ा
प्रकारको	प ् र क ा र क ो
प्रकारले	प ् र क ा र ल े
प्रकाश	प ् र क ा श
प्रकाशक	प ् र क ा श क
प्रकाशन	प ् र क ा श न
प्रकाशनले	प ् र क ा श न ल े
प्रकाशमा	प ् र क ा श म ा
प्रकाशित	प ् र क ा श ि त
प्रकोप	प ् र क ो प
प्रक्रिया	प ् र क ् र ि य ा
प्रक्रियागत	प ् र क ् र ि य ा ग त
प्रक्रियाहरूद्वारा	प ् र क ् र ि य ा ह र ू द ् व ा र ा
प्रखर	प ् र ख र
प्रख्यात	प ् र ख ् य ा त
प्रगति	प ् र ग त ि
प्रगतिको	प ् र ग त ि क ो
प्रचलनको	प ् र च ल न क ो
प्रचलित	प ् र च ल ि त
प्रचार	प ् र च ा र
प्रजातन्त्रवादी	प ् र ज ा त न ् त ् र व ा द ी
प्रजातान्त्रिक	प ् र ज ा त ा न ् त ् र ि क
प्रजाति	प ् र ज ा त ि
प्रजातिमा	प ् र ज ा त ि म ा
प्रडक्टसन	प ् र ड क ् ट स न
प्रणाली	प ् र ण ा ल ी
प्रणालीको	प ् र ण ा ल ी क ो
प्रति	प ् र त ि
प्रतिनिधि	प ् र त ि न ि ध ि
प्रतिबद्धता	प ् र त ि ब द ् ध त ा
प्रतिमा	प ् र त ि म ा
प्रतियोगिता	प ् र त ि य ो ग ि त ा
प्रतियोगितामा	प ् र त ि य ो ग ि त ा म ा
प्रतिरोध	प ् र त ि र ो ध
प्रतिलेखको	प ् र त ि ल े ख क ो
प्रतिविम्ब	प ् र त ि व ि म ् ब
प्रतिवेदन	प ् र त ि व े द न
प्रतिशत	प ् र त ि श त
प्रतिशतको	प ् र त ि श त क ो
प्रतिष्ठान	प ् र त ि ष ् ठ ा न
प्रतिस्पर्धा	प ् र त ि स ् प र ् ध ा
प्रतीकको	प ् र त ी क क ो
प्रत्येक	प ् र त ् य े क
प्रथम	प ् र थ म
प्रथमस्तर	प ् र थ म स ् त र
प्रदर्शक	प ् र द र ् श क
प्रदर्शन	प ् र द र ् श न
प्रदान	प ् र द ा न
प्रदायक	प ् र द ा य क
प्रदीप	प ् र द ी प
प्रदेश	प ् र द े श
प्रदेशमा	प ् र द े श म ा
प्रधान	प ् र ध ा न
प्रधानकार्यलय	प ् र ध ा न क ा र ् य ल य
प्रधानमन्त्री	प ् र ध ा न म न ् त ् र ी
प्रधानसँग	प ् र ध ा न स ँ ग
प्रनि	प ् र न ि
प्रपन्नाचार्यले	प ् र प न ् न ा च ा र ् य ल े
प्रबन्ध	प ् र ब न ् ध
प्रबन्धक	प ् र ब न ् ध क
प्रबन्धकले	प ् र ब न ् ध क ल े
प्रबल	प ् र ब ल
प्रभाव	प ् र भ ा व
प्रभावशाली	प ् र भ ा व श ा ल ी
प्रभावित	प ् र भ ा व ि त
प्रभु	प ् र भ ु
प्रमाणहरूका	प ् र म ा ण ह र ू क ा
प्रमाणिक	प ् र म ा ण ि क
प्रमाणिकरण	प ् र म ा ण ि क र ण
प्रमाणित	प ् र म ा ण ि त
प्रमुख	प ् र म ु ख
प्रमुखमा	प ् र म ु ख म ा
प्रयाप्त	प ् र य ा प ् त
प्रयास	प ् र य ा स
प्रयासमा	प ् र य ा स म ा
प्रयुक्त	प ् र य ु क ् त
प्रयोग	प ् र य ो ग
प्रयोगमा	प ् र य ो ग म ा
प्रयोगले	प ् र य ो ग ल े
प्रवाहित	प ् र व ा ह ि त
प्रविधि	प ् र व ि ध ि
प्रविधिको	प ् र व ि ध ि क ो
प्रविधियुक्त	प ् र व ि ध ि य ु क ् त
प्रवीण	प ् र व ी ण
प्रवेश	प ् र व े श
प्रवेशसँगै	प ् र व े श स ँ ग ै
प्रशंसा	प ् र श ं स ा
प्रशंसापत्र	प ् र श ं स ा प त ् र
प्रशस्त	प ् र श स ् त
प्रशस्तमात्रामा	प ् र श स ् त म ा त ् र ा म ा
प्रशान्त	प ् र श ा न ् त
प्रशासनले	प ् र श ा स न ल े
प्रशासनिक	प ् र श ा स न ि क
प्रशिक्षक	प ् र श ि क ् ष क
प्रशोधनका	प ् र श ो ध न क ा
प्रसङ्ग	प ् र स ङ ् ग
प्रसङ्गमा	प ् र स ङ ् ग म ा
प्रसङ्गलाई	प ् र स ङ ् ग ल ा ई
प्रसङ्गसँग	प ् र स ङ ् ग स ँ ग
प्रसादी	प ् र स ा द ी
प्रसाधन	प ् र स ा ध न
प्रसार	प ् र स ा र
प्रसारण	प ् र स ा र ण
प्रसिद्ध	प ् र स ि द ् ध
प्रसुती	प ् र स ु त ी
प्रस्तावलाई	प ् र स ् त ा व ल ा ई
प्रस्तुत	प ् र स ् त ु त
प्रस्तुति	प ् र स ् त ु त ि
प्रस्तुतिकरण	प ् र स ् त ु त ि क र ण
प्रस्तोता	प ् र स ् त ो त ा
प्रस्थान	प ् र स ् थ ा न
प्रहरी	प ् र ह र ी
प्रहरीको	प ् र ह र ी क ो
प्रहरीले	प ् र ह र ी ल े
प्रा	प ् र ा
प्राकृतिक	प ् र ा क ृ त ि क
प्रागमा	प ् र ा ग म ा
प्रागैतिहासिक	प ् र ा ग ै त ि ह ा स ि क
प्राचीन	प ् र ा च ी न
प्राचीनकालमा	प ् र ा च ी न क ा ल म ा
प्राथमिक	प ् र ा थ म ि क
प्राथमिकता	प ् र ा थ म ि क त ा
प्रान्त	प ् र ा न ् त
प्रान्तको	प ् र ा न ् त क ो
प्रान्तकोको	प ् र ा न ् त क ो क ो
प्रान्तमस	प ् र ा न ् त म स
प्रान्तमा	प ् र ा न ् त म ा
प्राप्त	प ् र ा प ् त
प्राय	प ् र ा य
प्रायः	प ् र ा य ः
प्रायद्विप	प ् र ा य द ् व ि प
प्रारम्भ	प ् र ा र म ् भ
प्रारम्भमा	प ् र ा र म ् भ म ा
प्रारम्भिक	प ् र ा र म ् भ ि क
प्रार्थना	प ् र ा र ् थ न ा
प्राविधिक	प ् र ा व ि ध ि क
प्रिनिया	प ् र ि न ि य ा
प्रिन्टमेकर	प ् र ि न ् ट म े क र
प्रिन्टर	प ् र ि न ् ट र
प्रिन्टेड	प ् र ि न ् ट े ड
प्रिन्स	प ् र ि न ् स
प्रिमियर	प ् र ि म ि य र
प्रिय	प ् र ि य
प्रियंका	प ् र ि य ं क ा
प्रिया	प ् र ि य ा
प्रुडेन्सियल	प ् र ु ड े न ् स ि य ल
प्रेमको	प ् र े म क ो
प्रेमध्वज	प ् र े म ध ् व ज
प्रेमराज	प ् र े म र ा ज
प्रेरणाराज्यलक्ष्मी	प ् र े र ण ा र ा ज ् य ल क ् ष ् म ी
प्रेरित	प ् र े र ि त
प्रोग्रामिङ	प ् र ो ग ् र ा म ि ङ
प्रोटनहरू	प ् र ो ट न ह र ू
प्रोटोन	प ् र ो ट ो न
प्रोटोस्टोम	प ् र ो ट ो स ् ट ो म
प्रोडक्टमार्फत	प ् र ो ड क ् ट म ा र ् फ त
प्रोफेसनल	प ् र ो फ े स न ल
प्रोसेसर	प ् र ो स े स र
प्लाजाकी	प ् ल ा ज ा क ी
प्लाटफर्म	प ् ल ा ट फ र ् म
प्लानेटरी	प ् ल ा न े ट र ी
प्लास्टिक	प ् ल ा स ् ट ि क
प्लेग	प ् ल े ग
प्लेन्स	प ् ल े न ् स
प्लेसेज	प ् ल े स े ज
फक्स	फ क ् स
फत्तेमान	फ त ् त े म ा न
फन्दामा	फ न ् द ा म ा
फरक	फ र क
फरकमा	फ र क म ा
फरवरीमा	फ र व र ी म ा
फर्किएन	फ र ् क ि ए न
फर्मुला	फ र ् म ु ल ा
फर्स्ट	फ र ् स ् ट
फलफुल	फ ल फ ु ल
फलाकदेखि	फ ल ा क द े ख ि
फल्ने	फ ल ् न े
फसल	फ स ल
फसलको	फ स ल क ो
फाँसी	फ ा ँ स ी
फाइनान्स	फ ा इ न ा न ् स
फाइनान्सिएल	फ ा इ न ा न ् स ि ए ल
फाइबर	फ ा इ ब र
फाइबरहरू	फ ा इ ब र ह र ू
फाइबरहरूको	फ ा इ ब र ह र ू क ो
फाइलम	फ ा इ ल म
फागुन	फ ा ग ु न
फाट	फ ा ट
फार	फ ा र
फारम	फ ा र म
फारिनोद्वारा	फ ा र ि न ो द ् व ा र ा
फारोई	फ ा र ो ई
फार्गो	फ ा र ् ग ो
फालिएको	फ ा ल ि ए क ो
फिजर	फ ि ज र
फिटको	फ ि ट क ो
फिदेल	फ ि द े ल
फिनल्याण्डको	फ ि न ल ् य ा ण ् ड क ो
फिनल्यान्ड	फ ि न ल ् य ा न ् ड
फिर्ता	फ ि र ् त ा
फिर्ती	फ ि र ् त ी
फिलाइट	फ ि ल ा इ ट
फिलिप	फ ि ल ि प
फिलिपिन्स	फ ि ल ि प ि न ् स
फिलिपिन्सका	फ ि ल ि प ि न ् स क ा
फिलिपिन्सको	फ ि ल ि प ि न ् स क ो
फिलिपिन्समा	फ ि ल ि प ि न ् स म ा
फिलिप्स	फ ि ल ि प ् स
फिलिम	फ ि ल ि म
फिल्ड	फ ि ल ् ड
फिल्म	फ ि ल ् म
फिल्मका	फ ि ल ् म क ा
फिल्मप्रेमी	फ ि ल ् म प ् र े म ी
फिल्ममा	फ ि ल ् म म ा
फिल्मसम्बन्धि	फ ि ल ् म स म ् ब न ् ध ि
फिल्मी	फ ि ल ् म ी
फिल्म्	फ ि ल ् म ्
फिसरम्यानका	फ ि स र म ् य ा न क ा
फुजीमोटोले	फ ु ज ी म ो ट ो ल े
फुटबल	फ ु ट ब ल
फुटबलको	फ ु ट ब ल क ो
फुटबलरको	फ ु ट ब ल र क ो
फुटेपछि	फ ु ट े प छ ि
फुड्स	फ ु ड ् स
फुलफुल्ने	फ ु ल फ ु ल ् न े
फुलाराको	फ ु ल ा र ा क ो
फुलेका	फ ु ल े क ा
फुस्रे	फ ु स ् र े
फूल	फ ू ल
फेडेक्स	फ े ड े क ् स
फेदी	फ े द ी
फेदीमा	फ े द ी म ा
फेब्रुअरी	फ े ब ् र ु अ र ी
फेरि	फ े र ि
फेरेका	फ े र े क ा
फेर्छु	फ े र ् छ ु
फेला	फ े ल ा
फेवा	फ े व ा
फेवाताल	फ े व ा त ा ल
फेवातालको	फ े व ा त ा ल क ो
फेसन	फ े स न
फेसनको	फ े स न क ो
फेस्टिभलमा	फ े स ् ट ि भ ल म ा
फैरिस	फ ै र ि स
फैलाउन	फ ै ल ा उ न
फैलाएको	फ ै ल ा ए क ो
फैलावट	फ ै ल ा व ट
फैलिएका	फ ै ल ि ए क ा
फैलिएको	फ ै ल ि ए क ो
फैलिन	फ ै ल ि न
फोक्सुण्डो	फ ो क ् स ु ण ् ड ो
फोक्सोमा	फ ो क ् स ो म ा
फोटोग्राफी	फ ो ट ो ग ् र ा फ ी
फोन	फ ो न
फोनको	फ ो न क ो
फोनमा	फ ो न म ा
फोर्कले	फ ो र ् क ल े
फोर्ड	फ ो र ् ड
फोले	फ ो ल े
फ्यान	फ ् य ा न
फ्यान्नीमायका	फ ् य ा न ् न ी म ा य क ा
फ्युल	फ ् य ु ल
फ्रस्ट	फ ् र स ् ट
फ्रान्स	फ ् र ा न ् स
फ्रान्सको	फ ् र ा न ् स क ो
फ्रान्सेली	फ ् र ा न ् स े ल ी
फ्री	फ ् र ी
फ्रेड्डी	फ ् र े ड ् ड ी
फ्रेन्च	फ ् र े न ् च
फ्रेन्डस	फ ् र े न ् ड स
फ्रेन्स	फ ् र े न ् स
फ्लागसिप	फ ् ल ा ग स ि प
फ्लेमब्याक	फ ् ल े म ब ् य ा क
फ्लेमिस	फ ् ल े म ि स
फ्लेस	फ ् ल े स
फ्लोरिडाको	फ ् ल ो र ि ड ा क ो
फ्लोरिडामा	फ ् ल ो र ि ड ा म ा
बंगाल	ब ं ग ा ल
बकस	ब क स
बक्छ	ब क ् छ
बगेको	ब ग े क ो
बगेडी	ब ग े ड ी
बगैँचाको	ब ग ै ँ च ा क ो
बग्ने	ब ग ् न े
बङालको	ब ङ ा ल क ो
बङ्गला	ब ङ ् ग ल ा
बङ्गारा	ब ङ ् ग ा र ा
बङ्गाल	ब ङ ् ग ा ल
बङ्गालको	ब ङ ् ग ा ल क ो
बङ्लादेशको	ब ङ ् ल ा द े श क ो
बचन	ब च न
बच्चाहरू	ब च ् च ा ह र ू
बच्चाहरूका	ब च ् च ा ह र ू क ा
बच्चु	ब च ् च ु
बच्न	ब च ् न
बच्ने	ब च ् न े
बजाइन्थ्यो	ब ज ा इ न ् थ ् य ो
बजाउने	ब ज ा उ न े
बजार	ब ज ा र
बजारको	ब ज ा र क ो
बजारमा	ब ज ा र म ा
बजारले	ब ज ा र ल े
बजारसमेत	ब ज ा र स म े त
बजारसम्म	ब ज ा र स म ् म
बजुलिया	ब ज ु ल ि य ा
बजे	ब ज े
बजेको	ब ज े क ो
बजेसम्म	ब ज े स म ् म
बज्राचार्य	ब ज ् र ा च ा र ् य
बज्राचार्यले	ब ज ् र ा च ा र ् य ल े
बझाङ	ब झ ा ङ
बटनी	ब ट न ी
बडीगाड	ब ड ी ग ा ड
बडुले	ब ड ु ल े
बढाउनु	ब ढ ा उ न ु
बढाए	ब ढ ा ए
बढाएको	ब ढ ा ए क ो
बढावा	ब ढ ा व ा
बढिएको	ब ढ ि ए क ो
बढिरहेको	ब ढ ि र ह े क ो
बढी	ब ढ ी
बढेको	ब ढ े क ो
बढैया	ब ढ ै य ा
बढ्दो	ब ढ ् द ो
बढ्न	ब ढ ् न
बढ्यो	ब ढ ् य ो
बतबाट	ब त ब ा ट
बताइएको	ब त ा इ ए क ो
बताइन	ब त ा इ न
बताइन्	ब त ा इ न ्
बताइन्छ	ब त ा इ न ् छ
बताइयो	ब त ा इ य ो
बताउँछन्	ब त ा उ ँ छ न ्
बताए	ब त ा ए
बताएका	ब त ा ए क ा
बताएको	ब त ा ए क ो
बतायो	ब त ा य ो
बती	ब त ी
बत्ती	ब त ् त ी
बत्तीस	ब त ् त ी स
बदरीनाथ	ब द र ी न ा थ
बध	ब ध
बना	ब न ा
बनाइ	ब न ा इ
बनाइएको	ब न ा इ ए क ो
बनाइदिन	ब न ा इ द ि न
बनाइन्छ	ब न ा इ न ् छ
बनाइसकेको	ब न ा इ स क े क ो
बनाउन	ब न ा उ न
बनाउनु	ब न ा उ न ु
बनाउने	ब न ा उ न े
बनाए	ब न ा ए
बनाएका	ब न ा ए क ा
बनाएको	ब न ा ए क ो
बनाएपछि	ब न ा ए प छ ि
बनायो	ब न ा य ो
बनारस	ब न ा र स
बनी	ब न ी
बनेका	ब न े क ा
बनेको	ब न े क ो
बनेर	ब न े र
बन्टिङ	ब न ् ट ि ङ
बन्ड	ब न ् ड
बन्द	ब न ् द
बन्दछ	ब न ् द छ
बन्धनमा	ब न ् ध न म ा
बन्ने	ब न ् न े
बन्यो	ब न ् य ो
बबई	ब ब ई
बबिशा	ब ब ि श ा
बम	ब म
बमको	ब म क ो
बयानब्बे	ब य ा न ब ् ब े
बयालिस	ब य ा ल ि स
बयालिसमा	ब य ा ल ि स म ा
बयालिसौँ	ब य ा ल ि स ौ ँ
बयासी	ब य ा स ी
बयासीमा	ब य ा स ी म ा
बरकेनमा	ब र क े न म ा
बरुवा	ब र ु व ा
बर्कसायर	ब र ् क स ा य र
बर्दिया	ब र ् द ि य ा
बर्नहार्ड	ब र ् न ह ा र ् ड
बर्नी	ब र ् न ी
बर्माको	ब र ् म ा क ो
बर्लिन	ब र ् ल ि न
बर्सामा	ब र ् स ा म ा
बल	ब ल
बलराम	ब ल र ा म
बलले	ब ल ल े
बलशाली	ब ल श ा ल ी
बलायर	ब ल ा य र
बलायरको	ब ल ा य र क ो
बलियो	ब ल ि य ो
बल्जित	ब ल ् ज ि त
बस	ब स
बसन्ती	ब स न ् त ी
बसाइसराइ	ब स ा इ स र ा इ
बसाई	ब स ा ई
बसिसकेको	ब स ि स क े क ो
बसेका	ब स े क ा
बसेको	ब स े क ो
बसेछन्	ब स े छ न ्
बसोबास	ब स ो ब ा स
बसोबासको	ब स ो ब ा स क ो
बस्दा	ब स ् द ा
बस्न	ब स ् न
बस्नु	ब स ् न ु
बस्नेत	ब स ् न े त
बस्नेमारिया	ब स ् न े म ा र ि य ा
बहन	ब ह न
बहरिन	ब ह र ि न
बहादुर	ब ह ा द ु र
बहिनी	ब ह ि न ी
बहु	ब ह ु
बहुमुखी	ब ह ु म ु ख ी
बहुराष्ट्रिय	ब ह ु र ा ष ् ट ् र ि य
बहुरूपिया	ब ह ु र ू प ि य ा
बहुविकल्पी	ब ह ु व ि क ल ् प ी
बाँडिएको	ब ा ँ ड ि ए क ो
बाँधिएकै	ब ा ँ ध ि ए क ै
बाँसका	ब ा ँ स क ा
बाइ	ब ा इ
बाइनरी	ब ा इ न र ी
बाइस	ब ा इ स
बाइसमा	ब ा इ स म ा
बाइसौँ	ब ा इ स ौ ँ
बाउन्न	ब ा उ न ् न
बाकु	ब ा क ु
बाक्लो	ब ा क ् ल ो
बागडोगरा	ब ा ग ड ो ग र ा
बागमती	ब ा ग म त ी
बाग्लुङ	ब ा ग ् ल ु ङ
बाग्लुङ्गको	ब ा ग ् ल ु ङ ् ग क ो
बाघको	ब ा घ क ो
बाज	ब ा ज
बाजरामा	ब ा ज र ा म ा
बाजुरा	ब ा ज ु र ा
बाट	ब ा ट
बाटाघाटा	ब ा ट ा घ ा ट ा
बाटामा	ब ा ट ा म ा
बाटे	ब ा ट े
बाटो	ब ा ट ो
बाटोमा	ब ा ट ो म ा
बाडेन	ब ा ड े न
बाणले	ब ा ण ल े
बातचीतको	ब ा त च ी त क ो
बादीको	ब ा द ी क ो
बाधा	ब ा ध ा
बानेश्वर	ब ा न े श ् व र
बाबु	ब ा ब ु
बाबुका	ब ा ब ु क ा
बाबुको	ब ा ब ु क ो
बाबुले	ब ा ब ु ल े
बाभारियाको	ब ा भ ा र ि य ा क ो
बाभारियामा	ब ा भ ा र ि य ा म ा
बायोफिजिसिस्ट	ब ा य ो फ ि ज ि स ि स ् ट
बायोसक्रिय	ब ा य ो स क ् र ि य
बार	ब ा र
बारका	ब ा र क ा
बारमा	ब ा र म ा
बारले	ब ा र ल े
बारहरूमध्ये	ब ा र ह र ू म ध ् य े
बारा	ब ा र ा
बारेमा	ब ा र े म ा
बारोक	ब ा र ो क
बार्न्सद्वारा	ब ा र ् न ् स द ् व ा र ा
बार्सिलोना	ब ा र ् स ि ल ो न ा
बाल	ब ा ल
बालकृष्ण	ब ा ल क ृ ष ् ण
बालबालिकाका	ब ा ल ब ा ल ि क ा क ा
बालबालिकामा	ब ा ल ब ा ल ि क ा म ा
बालबालिकाहरूलाई	ब ा ल ब ा ल ि क ा ह र ू ल ा ई
बालसखा	ब ा ल स ख ा
बाला	ब ा ल ा
बाली	ब ा ल ी
बालुवा	ब ा ल ु व ा
बालुवाको	ब ा ल ु व ा क ो
बाल्टिक	ब ा ल ् ट ि क
बाल्मो	ब ा ल ् म ो
बाल्यकालमा	ब ा ल ् य क ा ल म ा
बास	ब ा स
बासिन्दा	ब ा स ि न ् द ा
बासिन्दाका	ब ा स ि न ् द ा क ा
बासीको	ब ा स ी क ो
बासीहरू	ब ा स ी ह र ू
बास्केटबल	ब ा स ् क े ट ब ल
बास्केटबलका	ब ा स ् क े ट ब ल क ा
बास्सै	ब ा स ् स ै
बाहिर	ब ा ह ि र
बाहिरी	ब ा ह ि र ी
बाहुन्नमा	ब ा ह ु न ् न म ा
बाहेक	ब ा ह े क
बाह्य	ब ा ह ् य
बाह्र	ब ा ह ् र
बाह्रको	ब ा ह ् र क ो
बाह्रैमास	ब ा ह ् र ै म ा स
बाह्रौँ	ब ा ह ् र ौ ँ
बि	ब ि
बिइ	ब ि इ
बिउ	ब ि उ
बिउमन्टको	ब ि उ म न ् ट क ो
बिक	ब ि क
बिकको	ब ि क क ो
बिक्री	ब ि क ् र ी
बिक्रेता	ब ि क ् र े त ा
बिग्रँदो	ब ि ग ् र ँ द ो
बिग्रेका	ब ि ग ् र े क ा
बिङ्ग्समा	ब ि ङ ् ग ् स म ा
बिच	ब ि च
बिचको	ब ि च क ो
बिचबाट	ब ि च ब ा ट
बिचमा	ब ि च म ा
बिचैबाट	ब ि च ै ब ा ट
बिच्छीको	ब ि च ् छ ी क ो
बिछ्याइएको	ब ि छ ् य ा इ ए क ो
बिछ्याइयो	ब ि छ ् य ा इ य ो
बिजय	ब ि ज य
बिजिनेस	ब ि ज ि न े स
बिजुली	ब ि ज ु ल ी
बिटम्याप	ब ि ट म ् य ा प
बिदुर	ब ि द ु र
बिद्या	ब ि द ् य ा
बिना	ब ि न ा
बिनिशा	ब ि न ि श ा
बिबिसी	ब ि ब ि स ी
बिबोइङ	ब ि ब ो इ ङ
बिमला	ब ि म ल ा
बिमा	ब ि म ा
बियर	ब ि य र
बिराज	ब ि र ा ज
बिराटनगर	ब ि र ा ट न ग र
बिराटनगरका	ब ि र ा ट न ग र क ा
बिरामी	ब ि र ा म ी
बिरामीको	ब ि र ा म ी क ो
बिरामीहरू	ब ि र ा म ी ह र ू
बिरामीहरूको	ब ि र ा म ी ह र ू क ो
बिरुवाहरूको	ब ि र ु व ा ह र ू क ो
बिरेन्द्र	ब ि र े न ् द ् र
बिरेन्द्रनगर	ब ि र े न ् द ् र न ग र
बिर्सनुहुँदैन	ब ि र ् स न ु ह ु ँ द ै न
बिल	ब ि ल
बिलरी	ब ि ल र ी
बिल्डर्स	ब ि ल ् ड र ् स
बिष्ट	ब ि ष ् ट
बिसहजारी	ब ि स ह ज ा र ी
बिसाउँछन्	ब ि स ा उ ँ छ न ्
बिस्ट	ब ि स ् ट
बिस्टको	ब ि स ् ट क ो
बिस्तारै	ब ि स ् त ा र ै
बिहान	ब ि ह ा न
बिहानी	ब ि ह ा न ी
बिहानै	ब ि ह ा न ै
बिहार	ब ि ह ा र
बिहारस्थित	ब ि ह ा र स ् थ ि त
बिहीबार	ब ि ह ी ब ा र
बीउ	ब ी उ
बीक	ब ी क
बीस	ब ी स
बीसको	ब ी स क ो
बीसहजारी	ब ी स ह ज ा र ी
बीसौँ	ब ी स ौ ँ
बुँदे	ब ु ँ द े
बुकिङ्	ब ु क ि ङ ्
बुकिन्डोनन	ब ु क ि न ् ड ो न न
बुक्स	ब ु क ् स
बुखरा	ब ु ख र ा
बुचारेस्टमा	ब ु च ा र े स ् ट म ा
बुझाउन	ब ु झ ा उ न
बुझाउनु	ब ु झ ा उ न ु
बुझिन्छ	ब ु झ ि न ् छ
बुटवल	ब ु ट व ल
बुट्यान	ब ु ट ् य ा न
बुढाको	ब ु ढ ा क ो
बुढानिलकण्ठ	ब ु ढ ा न ि ल क ण ् ठ
बुढानिलकण्ठमा	ब ु ढ ा न ि ल क ण ् ठ म ा
बुढीगङ्गा	ब ु ढ ी ग ङ ् ग ा
बुद्ध	ब ु द ् ध
बुद्धिकृष्ण	ब ु द ् ध ि क ृ ष ् ण
बुधवार	ब ु ध व ा र
बुलबुल	ब ु ल ब ु ल
बुल्गेरियामा	ब ु ल ् ग े र ि य ा म ा
बुवाका	ब ु व ा क ा
बृहस्पति	ब ृ ह स ् प त ि
बे	ब े
बेइजिङ	ब े इ ज ि ङ
बेकरी	ब े क र ी
बेगनास	ब े ग न ा स
बेचेर	ब े च े र
बेडममा	ब े ड म म ा
बेनिनको	ब े न ि न क ो
बेनी	ब े न ी
बेनीमा	ब े न ी म ा
बेनीमाधव	ब े न ी म ा ध व
बेन्ट	ब े न ् ट
बेबिलोन	ब े ब ि ल ो न
बेमा	ब े म ा
बेलको	ब े ल क ो
बेला	ब े ल ा
बेलामा	ब े ल ा म ा
बेलायत	ब े ल ा य त
बेलायतको	ब े ल ा य त क ो
बेलायती	ब े ल ा य त ी
बेलारुस	ब े ल ा र ु स
बेल्जीयम	ब े ल ् ज ी य म
बेल्ट	ब े ल ् ट
बेसबल	ब े स ब ल
बेसी	ब े स ी
बेस्ट	ब े स ् ट
बैँकबाट	ब ै ँ क ब ा ट
बैङ्क	ब ै ङ ् क
बैङ्कको	ब ै ङ ् क क ो
बैङ्कले	ब ै ङ ् क ल े
बैङ्किङ्	ब ै ङ ् क ि ङ ्
बैठकमा	ब ै ठ क म ा
बैतडी	ब ै त ड ी
बैतडीस्थित	ब ै त ड ी स ् थ ि त
बैद्य	ब ै द ् य
बोकिने	ब ो क ि न े
बोकेको	ब ो क े क ो
बोक्ने	ब ो क ् न े
बोगोटा	ब ो ग ो ट ा
बोडेमा	ब ो ड े म ा
बोरस	ब ो र स
बोरा	ब ो र ा
बोर्ड	ब ो र ् ड
बोर्डिङ	ब ो र ् ड ि ङ
बोलाउन	ब ो ल ा उ न
बोलिने	ब ो ल ि न े
बोलिन्छ	ब ो ल ि न ् छ
बोलेको	ब ो ल े क ो
बोल्न	ब ो ल ् न
बोसले	ब ो स ल े
बोस्टनमा	ब ो स ् ट न म ा
बोहराको	ब ो ह र ा क ो
बोहराले	ब ो ह र ा ल े
बौद्ध	ब ौ द ् ध
बौद्धहरूको	ब ौ द ् ध ह र ू क ो
बौलाएर	ब ौ ल ा ए र
ब्यङ्ग्य	ब ् य ङ ् ग ् य
ब्यङ्य	ब ् य ङ ् य
ब्यङ्यात्मक	ब ् य ङ ् य ा त ् म क
ब्याङ्क	ब ् य ा ङ ् क
ब्याङ्कमा	ब ् य ा ङ ् क म ा
ब्याट	ब ् य ा ट
ब्यान्ड	ब ् य ा न ् ड
ब्याम्बर्जमा	ब ् य ा म ् ब र ् ज म ा
ब्याम्बलको	ब ् य ा म ् ब ल क ो
ब्युनर्स	ब ् य ु न र ् स
ब्रन्विस्को	ब ् र न ् व ि स ् क ो
ब्राउजर	ब ् र ा उ ज र
ब्राजिलका	ब ् र ा ज ि ल क ा
ब्राजिलको	ब ् र ा ज ि ल क ो
ब्राजिली	ब ् र ा ज ि ल ी
ब्रिजवाटर	ब ् र ि ज व ा ट र
ब्रिटिस	ब ् र ि ट ि स
ब्रिटेनी	ब ् र ि ट े न ी
ब्रेक	ब ् र े क
ब्रेन	ब ् र े न
ब्रोकरेज	ब ् र ो क र े ज
ब्रोड	ब ् र ो ड
ब्लाये	ब ् ल ा य े
ब्ल्याक	ब ् ल ् य ा क
ब्ल्याकक्याप्ड	ब ् ल ् य ा क क ् य ा प ् ड
ब्ल्याकरम्पेड	ब ् ल ् य ा क र म ् प े ड
ब्ल्याकहेडेड	ब ् ल ् य ा क ह े ड े ड
भइरहेको	भ इ र ह े क ो
भइसकेका	भ इ स क े क ा
भइसकेको	भ इ स क े क ो
भए	भ ए
भएका	भ ए क ा
भएकाले	भ ए क ा ल े
भएकी	भ ए क ी
भएकै	भ ए क ै
भएको	भ ए क ो
भएकोको	भ ए क ो क ो
भएपछि	भ ए प छ ि
भएपनि	भ ए प न ि
भएर	भ ए र
भक्त	भ क ् त
भक्तजनलाई	भ क ् त ज न ल ा ई
भक्तपुर	भ क ् त प ु र
भक्तपुरको	भ क ् त प ु र क ो
भक्तपुरले	भ क ् त प ु र ल े
भक्तराज	भ क ् त र ा ज
भगवती	भ ग व त ी
भगवान्	भ ग व ा न ्
भञ्ज्याङका	भ ञ ् ज ् य ा ङ क ा
भट्ट	भ ट ् ट
भट्टको	भ ट ् ट क ो
भट्टराई	भ ट ् ट र ा ई
भट्टराईको	भ ट ् ट र ा ई क ो
भट्टराईद्वारा	भ ट ् ट र ा ई द ् व ा र ा
भट्टराईले	भ ट ् ट र ा ई ल े
भट्टले	भ ट ् ट ल े
भण्डारण	भ ण ् ड ा र ण
भण्डारणको	भ ण ् ड ा र ण क ो
भण्डारी	भ ण ् ड ा र ी
भण्डारीको	भ ण ् ड ा र ी क ो
भत्कियो	भ त ् क ि य ो
भत्केका	भ त ् क े क ा
भदौ	भ द ौ
भद्रकाली	भ द ् र क ा ल ी
भद्रपुर	भ द ् र प ु र
भद्रपुरदेखि	भ द ् र प ु र द े ख ि
भनाइ	भ न ा इ
भनिएको	भ न ि ए क ो
भनिने	भ न ि न े
भनिन्छ	भ न ि न ् छ
भनिन्थ्यो	भ न ि न ् थ ् य ो
भनी	भ न ी
भने	भ न े
भनेको	भ न े क ो
भनेजस्तो	भ न े ज स ् त ो
भनेर	भ न े र
भन्दछन्	भ न ् द छ न ्
भन्दा	भ न ् द ा
भन्दै	भ न ् द ै
भन्न	भ न ् न
भन्नाले	भ न ् न ा ल े
भन्ने	भ न ् न े
भन्सार	भ न ् स ा र
भयंकर	भ य ं क र
भयप्रद	भ य प ् र द
भयानक	भ य ा न क
भयो	भ य ो
भर	भ र
भरखरै	भ र ख र ै
भरत	भ र त
भरतपुर	भ र त प ु र
भराभरीदेखि	भ र ा भ र ी द े ख ि
भरिएको	भ र ि ए क ो
भरिकाका	भ र ि क ा क ा
भर्डेको	भ र ् ड े क ो
भर्ना	भ र ् न ा
भलाइका	भ ल ा इ क ा
भलिबल	भ ल ि ब ल
भलिबलमा	भ ल ि ब ल म ा
भवन	भ व न
भवनको	भ व न क ो
भवनमा	भ व न म ा
भस्त्र	भ स ् त ् र
भाँडाकुँडा	भ ा ँ ड ा क ु ँ ड ा
भाँडामा	भ ा ँ ड ा म ा
भाँडो	भ ा ँ ड ो
भाइकिङ	भ ा इ क ि ङ
भाग	भ ा ग
भागको	भ ा ग क ो
भागबाट	भ ा ग ब ा ट
भागमा	भ ा ग म ा
भागसँगै	भ ा ग स ँ ग ै
भागहरू	भ ा ग ह र ू
भागिदारी	भ ा ग ि द ा र ी
भाग्य	भ ा ग ् य
भाडा	भ ा ड ा
भाडामा	भ ा ड ा म ा
भारत	भ ा र त
भारतका	भ ा र त क ा
भारतको	भ ा र त क ो
भारतबाटै	भ ा र त ब ा ट ै
भारतमा	भ ा र त म ा
भारतलाई	भ ा र त ल ा ई
भारतीय	भ ा र त ी य
भारी	भ ा र ी
भावी	भ ा व ी
भाषण	भ ा ष ण
भाषा	भ ा ष ा
भाषाका	भ ा ष ा क ा
भाषाको	भ ा ष ा क ो
भाषामा	भ ा ष ा म ा
भाषासम्बन्धी	भ ा ष ा स म ् ब न ् ध ी
भाषाहरू	भ ा ष ा ह र ू
भाषाहरूको	भ ा ष ा ह र ू क ो
भिक्षु	भ ि क ् ष ु
भिजेका	भ ि ज े क ा
भिठ्ठामोड	भ ि ठ ् ठ ा म ो ड
भिड	भ ि ड
भिडियो	भ ि ड ि य ो
भिड्न	भ ि ड ् न
भित्र	भ ि त ् र
भित्रको	भ ि त ् र क ो
भित्रैदेखि	भ ि त ् र ै द े ख ि
भिन्नै	भ ि न ् न ै
भिमान	भ ि म ा न
भिमेश्वर	भ ि म े श ् व र
भियतनामको	भ ि य त न ा म क ो
भियना	भ ि य न ा
भियनाको	भ ि य न ा क ो
भिराला	भ ि र ा ल ा
भिरालो	भ ि र ा ल ो
भिल्ला	भ ि ल ् ल ा
भीमसेन	भ ी म स े न
भीमसेनले	भ ी म स े न ल े
भीले	भ ी ल े
भुजेलले	भ ु ज े ल ल े
भुटान	भ ु ट ा न
भुटानी	भ ु ट ा न ी
भुपी	भ ु प ी
भुवन	भ ु व न
भूकम्प	भ ू क म ् प
भूकम्पको	भ ू क म ् प क ो
भूकम्पबाट	भ ू क म ् प ब ा ट
भूकम्पले	भ ू क म ् प ल े
भूगोलका	भ ू ग ो ल क ा
भूतको	भ ू त क ो
भूपतिन्द्र	भ ू प त ि न ् द ् र
भूबनावट	भ ू ब न ा व ट
भूबनोट	भ ू ब न ो ट
भूबनोटअन्तर्गत	भ ू ब न ो ट अ न ् त र ् ग त
भूभाग	भ ू भ ा ग
भूभागमा	भ ू भ ा ग म ा
भूमध्य	भ ू म ध ् य
भूमि	भ ू म ि
भूमिका	भ ू म ि क ा
भूमिकामा	भ ू म ि क ा म ा
भूमिको	भ ू म ि क ो
भूमिमाथि	भ ू म ि म ा थ ि
भूमिसुधार	भ ू म ि स ु ध ा र
भूशासस्त्री	भ ू श ा स स ् त ् र ी
भूसंरचनाको	भ ू स ं र च न ा क ो
भेक्टर	भ े क ् ट र
भेगमा	भ े ग म ा
भेट	भ े ट
भेटिएका	भ े ट ि ए क ा
भेटिएको	भ े ट ि ए क ो
भेटेका	भ े ट े क ा
भेडीगोठ	भ े ड ी ग ो ठ
भेदभाव	भ े द भ ा व
भेदास	भ े द ा स
भेनिस	भ े न ि स
भेनिसको	भ े न ि स क ो
भेनेटोको	भ े न े ट ो क ो
भेराइजन	भ े र ा इ ज न
भेराइटी	भ े र ा इ ट ी
भेरि	भ े र ि
भेरिस्क	भ े र ि स ् क
भेरी	भ े र ी
भैरव	भ ै र व
भैरहवा	भ ै र ह व ा
भैसकेका	भ ै स क े क ा
भोकमरीबाट	भ ो क म र ी ब ा ट
भोकमरीले	भ ो क म र ी ल े
भोज	भ ो ज
भोजन	भ ो ज न
भोजनालयमा	भ ो ज न ा ल य म ा
भोजनालयले	भ ो ज न ा ल य ल े
भोजपत्र	भ ो ज प त ् र
भोजपुर	भ ो ज प ु र
भोजराज	भ ो ज र ा ज
भोटेकोशी	भ ो ट े क ो श ी
भोलि	भ ो ल ि
भोलिको	भ ो ल ि क ो
भोलोग्डा	भ ो ल ो ग ् ड ा
भौगोलिक	भ ौ ग ो ल ि क
भौतिक	भ ौ त ि क
भ्याकुमा	भ ् य ा क ु म ा
भ्यान्कुभर	भ ् य ा न ् क ु भ र
भ्यालेरो	भ ् य ा ल े र ो
भ्रमण	भ ् र म ण
भ्रमणमा	भ ् र म ण म ा
भ्रष्ट	भ ् र ष ् ट
म	म
मई	म ई
मउन्नाइस	म उ न ् न ा इ स
मकवानपुर	म क व ा न प ु र
मकाउले	म क ा उ ल े
मकालु	म क ा ल ु
मकै	म क ै
मक्का	म क ् क ा
मक्काह	म क ् क ा ह
मक्वारी	म क ् व ा र ी
मगर	म ग र
मङोलियामा	म ङ ो ल ि य ा म ा
मङ्गल	म ङ ् ग ल
मङ्गलवार	म ङ ् ग ल व ा र
मङ्गोलियामा	म ङ ् ग ो ल ि य ा म ा
मङ्सिर	म ङ ् स ि र
मजबुत	म ज ब ु त
मजा	म ज ा
मञ्चमा	म ञ ् च म ा
मञ्जु	म ञ ् ज ु
मट्टा	म ट ् ट ा
मठ	म ठ
मठका	म ठ क ा
मठको	म ठ क ो
मठमा	म ठ म ा
मड्रिडको	म ड ् र ि ड क ो
मड्रिडमा	म ड ् र ि ड म ा
मण्डलमा	म ण ् ड ल म ा
मत	म त
मतदान	म त द ा न
मतलब	म त ल ब
मतलाई	म त ल ा ई
मताधिकारबाट	म त ा ध ि क ा र ब ा ट
मदन	म द न
मदनकृष्ण	म द न क ृ ष ् ण
मदिरा	म द ि र ा
मदीनातर्फ	म द ी न ा त र ् फ
मद्दत	म द ् द त
मध्य	म ध ् य
मध्यकालमा	म ध ् य क ा ल म ा
मध्यकालीन	म ध ् य क ा ल ी न
मध्यपश्चिमाञ्चल	म ध ् य प श ् च ि म ा ञ ् च ल
मध्यपश्चिमी	म ध ् य प श ् च ि म ी
मध्यपहाडी	म ध ् य प ह ा ड ी
मध्यपुर	म ध ् य प ु र
मध्यभागमा	म ध ् य भ ा ग म ा
मध्यम	म ध ् य म
मध्यमपश्चिमाञ्चल	म ध ् य म प श ् च ि म ा ञ ् च ल
मध्यमपश्चिमाञ्चलको	म ध ् य म प श ् च ि म ा ञ ् च ल क ो
मध्यमाञ्चल	म ध ् य म ा ञ ् च ल
मध्ययुगीन	म ध ् य य ु ग ी न
मध्यवर्ती	म ध ् य व र ् त ी
मध्ये	म ध ् य े
मध्येको	म ध ् य े क ो
मन	म न
मनपराउने	म न प र ा उ न े
मनपर्ने	म न प र ् न े
मनमोहक	म न म ो ह क
मनस्थिति	म न स ् थ ि त ि
मनाइने	म न ा इ न े
मनाएको	म न ा ए क ो
मनिटोबाको	म न ि ट ो ब ा क ो
मनिलामा	म न ि ल ा म ा
मनिषा	म न ि ष ा
मनुस्मृतिमा	म न ु स ् म ृ त ि म ा
मनोनयन	म न ो न य न
मनोरञ्जन	म न ो र ञ ् ज न
मनोरञ्जनका	म न ो र ञ ् ज न क ा
मनोरथ	म न ो र थ
मनोविज्ञान	म न ो व ि ज ् ञ ा न
मनोहरराम	म न ो ह र र ा म
मन्डेला	म न ् ड े ल ा
मन्त्रिमण्डल	म न ् त ् र ि म ण ् ड ल
मन्त्री	म न ् त ् र ी
मन्त्रीमण्डलमा	म न ् त ् र ी म ण ् ड ल म ा
मन्त्रीले	म न ् त ् र ी ल े
मन्त्रीस्तरीय	म न ् त ् र ी स ् त र ी य
मन्थली	म न ् थ ल ी
मन्दिर	म न ् द ि र
मरिसकेको	म र ि स क े क ो
मरेका	म र े क ा
मरेको	म र े क ो
मर्क	म र ् क
मर्कन्टाइल	म र ् क न ् ट ा इ ल
मर्छ	म र ् छ
मर्दी	म र ् द ी
मर्राकेस	म र ् र ा क े स
मर्स्याङ्दी	म र ् स ् य ा ङ ् द ी
मल	म ल
मलङ्गवामा	म ल ङ ् ग व ा म ा
मलमा	म ल म ा
मलयालम	म ल य ा ल म
मलयालमको	म ल य ा ल म क ो
मलले	म ल ल े
मलहरू	म ल ह र ू
मलाई	म ल ा ई
मलेसियामा	म ल े स ि य ा म ा
मल्टिकम्प्लेक्समा	म ल ् ट ि क म ् प ् ल े क ् स म ा
मल्ल	म ल ् ल
मल्लको	म ल ् ल क ो
मल्लबिच	म ल ् ल ब ि च
मल्लले	म ल ् ल ल े
मविविई	म व ि व ि ई
मसाजिर	म स ा ज ि र
मसाजिरगोल	म स ा ज ि र ग ो ल
मसालेदार	म स ा ल े द ा र
मसो	म स ो
मस्को	म स ् क ो
महँगो	म ह ँ ग ो
महकुमा	म ह क ु म ा
महको	म ह क ो
महत	म ह त
महत्त्व	म ह त ् त ् व
महत्त्वपूर्ण	म ह त ् त ् व प ू र ् ण
महराको	म ह र ा क ो
महल	म ह ल
महाँकाल	म ह ा ँ क ा ल
महाकाली	म ह ा क ा ल ी
महाकाव्य	म ह ा क ा व ् य
महात्म्यको	म ह ा त ् म ् य क ो
महादेवका	म ह ा द े व क ा
महादेवबाट	म ह ा द े व ब ा ट
महादेवलाई	म ह ा द े व ल ा ई
महादेश	म ह ा द े श
महादेशको	म ह ा द े श क ो
महाद्विपीय	म ह ा द ् व ि प ी य
महाद्वीपीय	म ह ा द ् व ी प ी य
महान	म ह ा न
महानगरपालिका	म ह ा न ग र प ा ल ि क ा
महानगरपालिकामा	म ह ा न ग र प ा ल ि क ा म ा
महान्	म ह ा न ्
महाभारत	म ह ा भ ा र त
महाभारतका	म ह ा भ ा र त क ा
महाभारतमा	म ह ा भ ा र त म ा
महामारी	म ह ा म ा र ी
महामारीका	म ह ा म ा र ी क ा
महामारीको	म ह ा म ा र ी क ो
महामारीबाट	म ह ा म ा र ी ब ा ट
महामारीले	म ह ा म ा र ी ल े
महामारीविदहरूको	म ह ा म ा र ी व ि द ह र ू क ो
महासचिव	म ह ा स च ि व
महासागरमा	म ह ा स ा ग र म ा
महासागरीय	म ह ा स ा ग र ी य
महिना	म ह ि न ा
महिनाको	म ह ि न ा क ो
महिनाभित्र	म ह ि न ा भ ि त ् र
महिनामा	म ह ि न ा म ा
महिनासम्म	म ह ि न ा स म ् म
महिला	म ह ि ल ा
महिषपाल	म ह ि ष प ा ल
महिषपालहरूलाई	म ह ि ष प ा ल ह र ू ल ा ई
महेन्द्र	म ह े न ् द ् र
महेन्द्रनगर	म ह े न ् द ् र न ग र
महेन्द्रराजमार्गको	म ह े न ् द ् र र ा ज म ा र ् ग क ो
महेशविक्रमद्वारा	म ह े श व ि क ् र म द ् व ा र ा
महोतरी	म ह ो त र ी
महोत्सवको	म ह ो त ् स व क ो
मा	म ा
माँझ	म ा ँ झ
माइक्रो	म ा इ क ् र ो
माइक्रोसफ्ट	म ा इ क ् र ो स फ ् ट
माइक्रोसफ्टद्वारा	म ा इ क ् र ो स फ ् ट द ् व ा र ा
माइत	म ा इ त
माउन्टडिजिट	म ा उ न ् ट ड ि ज ि ट
माउरिटिअसको	म ा उ र ि ट ि अ स क ो
माओवादीको	म ा ओ व ा द ी क ो
माकुरा	म ा क ु र ा
माकुराहरू	म ा क ु र ा ह र ू
माग्दै	म ा ग ् द ै
माघ	म ा घ
माछापुच्छ्रे	म ा छ ा प ु च ् छ ् र े
माछापु्च्छ्रे	म ा छ ा प ु ् च ् छ ् र े
माटोका	म ा ट ो क ा
माटोको	म ा ट ो क ो
माडीको	म ा ड ी क ो
माता	म ा त ा
मातान्जास	म ा त ा न ् ज ा स
मातान्हास	म ा त ा न ् ह ा स
मातृभाषा	म ा त ृ भ ा ष ा
मातृभाषासँगै	म ा त ृ भ ा ष ा स ँ ग ै
मात्र	म ा त ् र
मात्राको	म ा त ् र ा क ो
मात्रामा	म ा त ् र ा म ा
माथि	म ा थ ि
माथिको	म ा थ ि क ो
माथितिर	म ा थ ि त ि र
मादी	म ा द ी
माधव	म ा ध व
माध्यम	म ा ध ् य म
माध्यमको	म ा ध ् य म क ो
माध्यमबाट	म ा ध ् य म ब ा ट
माध्यमिक	म ा ध ् य म ि क
माध्यामिक	म ा ध ् य ा म ि क
मान	म ा न
मानक	म ा न क
मानन्धर	म ा न न ् ध र
मानन्धरलाई	म ा न न ् ध र ल ा ई
मानव	म ा न व
मानवअधिकारको	म ा न व अ ध ि क ा र क ो
मानवतावादी	म ा न व त ा व ा द ी
मानसिक	म ा न स ि क
मानिएका	म ा न ि ए क ा
मानिएको	म ा न ि ए क ो
मानिने	म ा न ि न े
मानिन्छ	म ा न ि न ् छ
मानिस	म ा न ि स
मानिसको	म ा न ि स क ो
मानिसले	म ा न ि स ल े
मानिसहरू	म ा न ि स ह र ू
मानिसहरूको	म ा न ि स ह र ू क ो
मानिसहरूद्वारा	म ा न ि स ह र ू द ् व ा र ा
मानिसहरूलाई	म ा न ि स ह र ू ल ा ई
मानी	म ा न ी
मानेका	म ा न े क ा
मान्छे	म ा न ् छ े
मान्दछन्	म ा न ् द छ न ्
मान्न	म ा न ् न
मान्नुपर्ने	म ा न ् न ु प र ् न े
मान्ने	म ा न ् न े
मान्यता	म ा न ् य त ा
मान्यताको	म ा न ् य त ा क ो
मान्यतालाई	म ा न ् य त ा ल ा ई
मान्यार्थ	म ा न ् य ा र ् थ
मापसे	म ा प स े
माफी	म ा फ ी
माम्री	म ा म ् र ी
मायमी	म ा य म ी
माया	म ा य ा
मायाको	म ा य ा क ो
मायादेवी	म ा य ा द े व ी
मारिए	म ा र ि ए
मारिसकेको	म ा र ि स क े क ो
मार्क	म ा र ् क
मार्कअप	म ा र ् क अ प
मार्किस्कर	म ा र ् क ि स ् क र
मार्केट	म ा र ् क े ट
मार्गदर्शक	म ा र ् ग द र ् श क
मार्गदेखि	म ा र ् ग द े ख ि
मार्गमा	म ा र ् ग म ा
मार्च	म ा र ् च
मार्फत	म ा र ् फ त
मार्सल	म ा र ् स ल
मालिक	म ा ल ि क
माल्दिभ्सलाई	म ा ल ् द ि भ ् स ल ा ई
मास	म ा स
मास्केको	म ा स ् क े क ो
मास्कोमा	म ा स ् क ो म ा
मास्टर	म ा स ् ट र
मास्लाभिना	म ा स ् ल ा भ ि न ा
माहामारीको	म ा ह ा म ा र ी क ो
मिटर	म ि ट र
मिटरदेखि	म ि ट र द े ख ि
मिटरभन्दा	म ि ट र भ न ् द ा
मिठो	म ि ठ ो
मिडफिल्डर	म ि ड फ ि ल ् ड र
मिडफिल्डरको	म ि ड फ ि ल ् ड र क ो
मिडल्यान्डका	म ि ड ल ् य ा न ् ड क ा
मिडियाका	म ि ड ि य ा क ा
मित्रता	म ि त ् र त ा
मित्रसेन	म ि त ् र स े न
मिथकमा	म ि थ क म ा
मिथिला	म ि थ ि ल ा
मिथीला	म ि थ ी ल ा
मिथेनबाट	म ि थ े न ब ा ट
मिनेटको	म ि न े ट क ो
मिरमिरे	म ि र म ि र े
मिल	म ि ल
मिलरद्वारा	म ि ल र द ् व ा र ा
मिलाउँदैछ	म ि ल ा उ ँ द ै छ
मिलानमा	म ि ल ा न म ा
मिलिटरी	म ि ल ि ट र ी
मिलेका	म ि ल े क ा
मिलेर	म ि ल े र
मिल्की	म ि ल ् क ी
मिल्दछ	म ि ल ् द छ
मिल्दैन	म ि ल ् द ै न
मिल्लरद्वारा	म ि ल ् ल र द ् व ा र ा
मिश्रको	म ि श ् र क ो
मिसन	म ि स न
मिसाइन्छ	म ि स ा इ न ् छ
मिसाइलको	म ि स ा इ ल क ो
मिसिगनमा	म ि स ि ग न म ा
मिसिन	म ि स ि न
मिसिन्छ	म ि स ि न ् छ
मिसिन्छन्	म ि स ि न ् छ न ्
मुक्त	म ु क ् त
मुख्य	म ु ख ् य
मुख्यतः	म ु ख ् य त ः
मुख्यतया	म ु ख ् य त य ा
मुख्यता	म ु ख ् य त ा
मुख्यमन्त्री	म ु ख ् य म न ् त ् र ी
मुख्यालय	म ु ख ् य ा ल य
मुगु	म ु ग ु
मुटु	म ु ट ु
मुटुको	म ु ट ु क ो
मुद्दाको	म ु द ् द ा क ो
मुद्दामा	म ु द ् द ा म ा
मुद्दामामिलाहरूमध्ये	म ु द ् द ा म ा म ि ल ा ह र ू म ध ् य े
मुद्रण	म ु द ् र ण
मुद्रा	म ु द ् र ा
मुनाफ	म ु न ा फ
मुनाफा	म ु न ा फ ा
मुनिया	म ु न ि य ा
मुनियाँ	म ु न ि य ा ँ
मुम्बइ	म ु म ् ब इ
मुरलीधर	म ु र ल ी ध र
मुरी	म ु र ी
मुर्तीहरूदेखि	म ु र ् त ी ह र ू द े ख ि
मुलुकहरूको	म ु ल ु क ह र ू क ो
मुलूकको	म ु ल ू क क ो
मुसा	म ु स ा
मुसिकोट	म ु स ि क ो ट
मुस्ताङ	म ु स ् त ा ङ
मुस्लिम	म ु स ् ल ि म
मुहम्मदको	म ु ह म ् म द क ो
मुहान	म ु ह ा न
मुहानसँगै	म ु ह ा न स ँ ग ै
मूर्ति	म ू र ् त ि
मूर्तिकार	म ू र ् त ि क ा र
मूर्तिको	म ू र ् त ि क ो
मूर्तिलाई	म ू र ् त ि ल ा ई
मूल	म ू ल
मूलका	म ू ल क ा
मूलकी	म ू ल क ी
मूलथलो	म ू ल थ ल ो
मूल्य	म ू ल ् य
मूल्याङ्कन	म ू ल ् य ा ङ ् क न
मृत्यु	म ृ त ् य ु
मृत्युको	म ृ त ् य ु क ो
मृत्युसम्म	म ृ त ् य ु स म ् म
मे	म े
मेकर	म े क र
मेक्सिकन	म े क ् स ि क न
मेक्सिको	म े क ् स ि क ो
मेक्सिकोको	म े क ् स ि क ो क ो
मेक्सिकोमा	म े क ् स ि क ो म ा
मेघालयमा	म े घ ा ल य म ा
मेची	म े च ी
मेजरमा	म े ज र म ा
मेटलाइफ	म े ट ल ा इ फ
मेट्रो	म े ट ् र ो
मेडिकल	म े ड ि क ल
मेडियम	म े ड ि य म
मेद्भिदेभसँग	म े द ् भ ि द े भ स ँ ग
मेन	म े न
मेन्ज	म े न ् ज
मेमोरियल	म े म ो र ि य ल
मेरिज	म े र ि ज
मेरिडाको	म े र ि ड ा क ो
मेरिल्यान्डमा	म े र ि ल ् य ा न ् ड म ा
मेरी	म े र ी
मेरो	म े र ो
मेलम्ची	म े ल म ् च ी
मेला	म े ल ा
मेलिना	म े ल ि न ा
मेवा	म े व ा
मेसिज	म े स ि ज
मेसिनरी	म े स ि न र ी
मेसिनले	म े स ि न ल े
मेसो	म े स ो
मेसोपोटामियातर्फ	म े स ो प ो ट ा म ि य ा त र ् फ
मेहनती	म े ह न त ी
मैत्री	म ै त ् र ी
मैदानबाट	म ै द ा न ब ा ट
मैदानी	म ै द ा न ी
मैदी	म ै द ी
मैनाली	म ै न ा ल ी
मैले	म ै ल े
मोजार्टद्वारा	म ो ज ा र ् ट द ् व ा र ा
मोटरखेल	म ो ट र ख े ल
मोटरबाटो	म ो ट र ब ा ट ो
मोटरले	म ो ट र ल े
मोटर्स	म ो ट र ् स
मोटोर	म ो ट ो र
मोडल	म ो ड ल
मोडिन्छ	म ो ड ि न ् छ
मोडेल	म ो ड े ल
मोदी	म ो द ी
मोनालिसाका	म ो न ा ल ि स ा क ा
मोन्टेनेग्रोमा	म ो न ् ट े न े ग ् र ो म ा
मोन्डेलेज	म ो न ् ड े ल े ज
मोबाइल	म ो ब ा इ ल
मोबाइलको	म ो ब ा इ ल क ो
मोबाइलले	म ो ब ा इ ल ल े
मोम	म ो म
मोमो	म ो म ो
मोमोज	म ो म ो ज
मोमोरीयल	म ो म ो र ी य ल
मोरक्को	म ो र क ् क ो
मोरिस	म ो र ि स
मोर्गन	म ो र ् ग न
मोर्चाहरूको	म ो र ् च ा ह र ू क ो
मोल्डोभान	म ो ल ् ड ो भ ा न
मोहन	म ो ह न
मोहनजोदाडो	म ो ह न ज ो द ा ड ो
मौखिक	म ौ ख ि क
मौला	म ौ ल ा
मौलिकलाई	म ौ ल ि क ल ा ई
मौसम	म ौ स म
मौसममा	म ौ स म म ा
मौसमी	म ौ स म ी
म्या	म ् य ा
म्याकको	म ् य ा क क ो
म्याकडोनाल्डस	म ् य ा क ड ो न ा ल ् ड स
म्याक्स	म ् य ा क ् स
म्याक्सिम	म ् य ा क ् स ि म
म्याग्दी	म ् य ा ग ् द ी
म्याग्नेटिज्ड	म ् य ा ग ् न े ट ि ज ् ड
म्याङा	म ् य ा ङ ा
म्याडम	म ् य ा ड म
म्यानमार	म ् य ा न म ा र
म्यान्मार	म ् य ा न ् म ा र
म्याप्स	म ् य ा प ् स
म्याराथन	म ् य ा र ा थ न
म्यासेडोनिया	म ् य ा स े ड ो न ि य ा
म्युचुअल	म ् य ु च ु अ ल
म्युनिखका	म ् य ु न ि ख क ा
म्लेच्छ	म ् ल े च ् छ
यज्ञबहादुरलाई	य ज ् ञ ब ह ा द ु र ल ा ई
यज्ञराज	य ज ् ञ र ा ज
यति	य त ि
यत्रतत्र	य त ् र त त ् र
यथावत्	य थ ा व त ्
यथेष्ट	य थ े ष ् ट
यद्दावधि	य द ् द ा व ध ि
यद्यपि	य द ् य प ि
यन्त्र	य न ् त ् र
यस	य स
यसअघि	य स अ घ ि
यसका	य स क ा
यसको	य स क ो
यसपछि	य स प छ ि
यसपछिका	य स प छ ि क ा
यसपालिको	य स प ा ल ि क ो
यसबाट	य स ब ा ट
यसबाहेक	य स ब ा ह े क
यसभित्र	य स भ ि त ् र
यसभित्रका	य स भ ि त ् र क ा
यसरी	य स र ी
यसलाई	य स ल ा ई
यसले	य स ल े
यसलेकोकाकोलासँग	य स ल े क ो क ा क ो ल ा स ँ ग
यसै	य स ै
यसो	य स ो
यस्ता	य स ् त ा
यस्तो	य स ् त ो
यहाँ	य ह ा ँ
यहाँका	य ह ा ँ क ा
यहाँको	य ह ा ँ क ो
यहाँदेखि	य ह ा ँ द े ख ि
यहाँबाट	य ह ा ँ ब ा ट
यही	य ह ी
यहुदी	य ह ु द ी
यहुदीसमुदायमाथि	य ह ु द ी स म ु द ा य म ा थ ि
यहुदीहरूको	य ह ु द ी ह र ू क ो
याइन्छ	य ा इ न ् छ
याउनु	य ा उ न ु
याएको	य ा ए क ो
यातयात	य ा त य ा त
यातायात	य ा त ा य ा त
यात्रा	य ा त ् र ा
यात्रामा	य ा त ् र ा म ा
यात्री	य ा त ् र ी
यादव	य ा द व
यादवले	य ा द व ल े
यान्त्रिकता	य ा न ् त ् र ि क त ा
यापर	य ा प र
यिनलाई	य ि न ल ा ई
यिनी	य ि न ी
यिनीहरू	य ि न ी ह र ू
यी	य ी
युएस	य ु ए स
युएसअमेरिकन	य ु ए स अ म े र ि क न
युकियोए	य ु क ि य ो ए
युक्रेन	य ु क ् र े न
युक्रेनी	य ु क ् र े न ी
युगोस्लाभिया	य ु ग ो स ् ल ा भ ि य ा
युग्मन	य ु ग ् म न
युटिसीको	य ु ट ि स ी क ो
युद्ध	य ु द ् ध
युद्धको	य ु द ् ध क ो
युद्धमा	य ु द ् ध म ा
युद्धहरूमा	य ु द ् ध ह र ू म ा
युनाइटेड	य ु न ा इ ट े ड
युनाइटेडहेल्थ	य ु न ा इ ट े ड ह े ल ् थ
युनिभर्सिटिबाट	य ु न ि भ र ् स ि ट ि ब ा ट
युनियनहरूको	य ु न ि य न ह र ू क ो
युनेस्को	य ु न े स ् क ो
युर	य ु र
युरालमा	य ु र ा ल म ा
युरेसियन	य ु र े स ि य न
युरेसियाको	य ु र े स ि य ा क ो
युरोप	य ु र ो प
युरोपको	य ु र ो प क ो
युरोपभरि	य ु र ो प भ र ि
युरोपेली	य ु र ो प े ल ी
युरोपेलीहरूलाई	य ु र ो प े ल ी ह र ू ल ा ई
यूरेशिया	य ू र े श ि य ा
यूरोप	य ू र ो प
यूरोपेलीहरू	य ू र ो प े ल ी ह र ू
यो	य ो
योगदान	य ो ग द ा न
योगदानका	य ो ग द ा न क ा
योगदानको	य ो ग द ा न क ो
योगदानलाई	य ो ग द ा न ल ा ई
योगाम्बर	य ो ग ा म ् ब र
योगी	य ो ग ी
योग्य	य ो ग ् य
योङ	य ो ङ
योजना	य ो ज न ा
योर्क	य ो र ् क
यौरा	य ौ र ा
र	र
रक	र क
रकम	र क म
रकेटको	र क े ट क ो
रक्षा	र क ् ष ा
रक्सी	र क ् स ी
रक्सौलमा	र क ् स ौ ल म ा
रगत	र ग त
रग्बी	र ग ् ब ी
रङ	र ङ
रङको	र ङ क ो
रङ्गमञ्चमा	र ङ ् ग म ञ ् च म ा
रचना	र च न ा
रचित	र च ि त
रचे	र च े
रचेका	र च े क ा
रचेको	र च े क ो
रजक	र ज क
रजत	र ज त
रजिना	र ज ि न ा
रत्न	र त ् न
रत्नदास	र त ् न द ा स
रत्ननगर	र त ् न न ग र
रत्नभक्त	र त ् न भ क ् त
रत्ना	र त ् न ा
रथी	र थ ी
रनहरू	र न ह र ू
रमणीय	र म ण ी य
रमाइलो	र म ा इ ल ो
रमाइलोमा	र म ा इ ल ो म ा
रमित	र म ि त
रमिरहेका	र म ि र ह े क ा
रमेश	र म े श
रमेशकुमार	र म े श क ु म ा र
रसायन	र स ा य न
रसियाका	र स ि य ा क ा
रसियाको	र स ि य ा क ो
रसुवा	र स ु व ा
रहँदा	र ह ँ द ा
रहँदाको	र ह ँ द ा क ो
रहँदै	र ह ँ द ै
रहने	र ह न े
रहन्छ	र ह न ् छ
रहन्छन्	र ह न ् छ न ्
रहस्य	र ह स ् य
रहस्यमय	र ह स ् य म य
रहे	र ह े
रहेका	र ह े क ा
रहेको	र ह े क ो
रहेछन्	र ह े छ न ्
राइजिङ	र ा इ ज ि ङ
राइट	र ा इ ट
राइन	र ा इ न
राइनल्यान्डमा	र ा इ न ल ् य ा न ् ड म ा
राइनवेस्टफेलिया	र ा इ न व े स ् ट फ े ल ि य ा
राइनवेस्टफेलियाको	र ा इ न व े स ् ट फ े ल ि य ा क ो
राइफल्समा	र ा इ फ ल ् स म ा
राई	र ा ई
राईको	र ा ई क ो
राउल	र ा उ ल
राखिएका	र ा ख ि ए क ा
राखिएको	र ा ख ि ए क ो
राखिन्छ	र ा ख ि न ् छ
राखियो	र ा ख ि य ो
राखेका	र ा ख े क ा
राखेको	र ा ख े क ो
राख्	र ा ख ्
राख्दछ	र ा ख ् द छ
राख्दा	र ा ख ् द ा
राख्न	र ा ख ् न
राख्ने	र ा ख ् न े
रागहरूको	र ा ग ह र ू क ो
राज	र ा ज
राजकाजका	र ा ज क ा ज क ा
राजकुमार	र ा ज क ु म ा र
राजकुमारद्वारा	र ा ज क ु म ा र द ् व ा र ा
राजकुमारहरूलाई	र ा ज क ु म ा र ह र ू ल ा ई
राजकुल	र ा ज क ु ल
राजतन्त्र	र ा ज त न ् त ् र
राजदरबारको	र ा ज द र ब ा र क ो
राजधानी	र ा ज ध ा न ी
राजधानीको	र ा ज ध ा न ी क ो
राजधानीसँगै	र ा ज ध ा न ी स ँ ग ै
राजनितिज्ञ	र ा ज न ि त ि ज ् ञ
राजनीति	र ा ज न ी त ि
राजनीतिक	र ा ज न ी त ि क
राजनीतिज्ञ	र ा ज न ी त ि ज ् ञ
राजनीतिमा	र ा ज न ी त ि म ा
राजनेता	र ा ज न े त ा
राजबल्लभ	र ा ज ब ल ् ल भ
राजभण्डारी	र ा ज भ ण ् ड ा र ी
राजमार्ग	र ा ज म ा र ् ग
राजमार्गबाट	र ा ज म ा र ् ग ब ा ट
राजमार्गलाई	र ा ज म ा र ् ग ल ा ई
राजमार्गले	र ा ज म ा र ् ग ल े
राजमार्गसँग	र ा ज म ा र ् ग स ँ ग
राजवंशका	र ा ज व ं श क ा
राजवंशको	र ा ज व ं श क ो
राजविराजबाट	र ा ज व ि र ा ज ब ा ट
राजविराजमा	र ा ज व ि र ा ज म ा
राजस्थानका	र ा ज स ् थ ा न क ा
राजस्थानमा	र ा ज स ् थ ा न म ा
राजस्व	र ा ज स ् व
राजा	र ा ज ा
राजाको	र ा ज ा क ो
राजामा	र ा ज ा म ा
राजालाई	र ा ज ा ल ा ई
राजाले	र ा ज ा ल े
राजिनामा	र ा ज ि न ा म ा
राजिव	र ा ज ि व
राजु	र ा ज ु
राजेन्द्रबहादुर	र ा ज े न ् द ् र ब ह ा द ु र
राजेश	र ा ज े श
राजेशपायल	र ा ज े श प ा य ल
राज्य	र ा ज ् य
राज्यकालमा	र ा ज ् य क ा ल म ा
राज्यको	र ा ज ् य क ो
राज्यमा	र ा ज ् य म ा
राज्यसम्म	र ा ज ् य स म ् म
राज्यहरूमा	र ा ज ् य ह र ू म ा
रात	र ा त
रातमाटे	र ा त म ा ट े
रातीको	र ा त ी क ो
रातीबाटै	र ा त ी ब ा ट ै
रातो	र ा त ो
राना	र ा न ा
रानी	र ा न ी
राप्ती	र ा प ् त ी
राफ्टिङका	र ा फ ् ट ि ङ क ा
राफ्टिङको	र ा फ ् ट ि ङ क ो
राम	र ा म
रामकृष्ण	र ा म क ृ ष ् ण
रामग्राम	र ा म ग ् र ा म
रामचरितमलाई	र ा म च र ि त म ल ा ई
रामचरितम्	र ा म च र ि त म ्
रामलाल	र ा म ल ा ल
रामायण	र ा म ा य ण
रामेछाप	र ा म े छ ा प
राम्ररी	र ा म ् र र ी
राम्रा	र ा म ् र ा
राम्रो	र ा म ् र ो
राम्रोसँग	र ा म ् र ो स ँ ग
राय	र ा य
रायमा	र ा य म ा
रायमाझी	र ा य म ा झ ी
रायोनमा	र ा य ो न म ा
रावलको	र ा व ल क ो
राष्ट्र	र ा ष ् ट ् र
राष्ट्रपति	र ा ष ् ट ् र प त ि
राष्ट्रपतिलाई	र ा ष ् ट ् र प त ि ल ा ई
राष्ट्रवादी	र ा ष ् ट ् र व ा द ी
राष्ट्रहरूबाट	र ा ष ् ट ् र ह र ू ब ा ट
राष्ट्रिय	र ा ष ् ट ् र ि य
राहत	र ा ह त
राहतको	र ा ह त क ो
रिजाल	र ि ज ा ल
रिजेन्सी	र ि ज े न ् स ी
रिपब्लिक	र ि प ब ् ल ि क
रिपुअरियन	र ि प ु अ र ि य न
रिपोर्ट	र ि प ो र ् ट
रिभर	र ि भ र
रिमा	र ि म ा
रिमाउस्कीमा	र ि म ा उ स ् क ी म ा
रिमालकी	र ि म ा ल क ी
रियाद	र ि य ा द
रिलायन्स	र ि ल ा य न ् स
रुचाउनेहरूले	र ु च ा उ न े ह र ू ल े
रुचि	र ु च ि
रुपन्देहीको	र ु प न ् द े ह ी क ो
रुपैयाँ	र ु प ै य ा ँ
रुपैयाा	र ु प ै य ा ा
रुम्बा	र ु म ् ब ा
रुष्ट	र ु ष ् ट
रुस	र ु स
रुसको	र ु स क ो
रुसमा	र ु स म ा
रुससँग	र ु स स ँ ग
रुसी	र ु स ी
रूद्रबेनीमा	र ू द ् र ब े न ी म ा
रूप	र ू प
रूपन्देही	र ू प न ् द े ह ी
रूपमा	र ू प म ा
रूपले	र ू प ल े
रूपसँग	र ू प स ँ ग
रूपा	र ू प ा
रूपाताल	र ू प ा त ा ल
रे	र े
रेकर	र े क र
रेकर्ड	र े क र ् ड
रेकर्डिङ्	र े क र ् ड ि ङ ्
रेखा	र े ख ा
रेखाद्वारा	र े ख ा द ् व ा र ा
रेखाहरू	र े ख ा ह र ू
रेग्नान्ट	र े ग ् न ा न ् ट
रेग्मी	र े ग ् म ी
रेग्मीको	र े ग ् म ी क ो
रेजिना	र े ज ि न ा
रेडियो	र े ड ि य ो
रेनासाइन्स	र े न ा स ा इ न ् स
रेनु	र े न ु
रेल	र े ल
रेलकारबाटै	र े ल क ा र ब ा ट ै
रेलमा	र े ल म ा
रेलवे	र े ल व े
रेलवेहरू	र े ल व े ह र ू
रेलिङनै	र े ल ि ङ न ै
रेसकार	र े स क ा र
रेसर	र े स र
रेसिङ	र े स ि ङ
रेस्टुराँ	र े स ् ट ु र ा ँ
रेस्टुरेन्ट	र े स ् ट ु र े न ् ट
रेस्टुरेन्टको	र े स ् ट ु र े न ् ट क ो
रेस्टुरेन्टमा	र े स ् ट ु र े न ् ट म ा
रेस्टुरेन्टले	र े स ् ट ु र े न ् ट ल े
रेस्टो	र े स ् ट ो
रेहडन	र े ह ड न
रैथाने	र ै थ ा न े
रोकायाका	र ो क ा य ा क ा
रोकायाको	र ो क ा य ा क ो
रोग	र ो ग
रोगको	र ो ग क ो
रोगजनकको	र ो ग ज न क क ो
रोगबाट	र ो ग ब ा ट
रोगब्याधबाट	र ो ग ब ् य ा ध ब ा ट
रोगव्याधि	र ो ग व ् य ा ध ि
रोगहरू	र ो ग ह र ू
रोगहरूको	र ो ग ह र ू क ो
रोचक	र ो च क
रोजमेरी	र ो ज म े र ी
रोडमा	र ो ड म ा
रोनमा	र ो न म ा
रोपवे	र ो प व े
रोपवेका	र ो प व े क ा
रोमक्याथोलिक	र ो म क ् य ा थ ो ल ि क
रोमद्वारा	र ो म द ् व ा र ा
रोमन	र ो म न
रोमनक्याथोलिक	र ो म न क ् य ा थ ो ल ि क
रोममा	र ो म म ा
रोमानिया	र ो म ा न ि य ा
रोमानियामा	र ो म ा न ि य ा म ा
रोमानियाली	र ो म ा न ि य ा ल ी
रोमान्चक	र ो म ा न ् च क
रोमान्टिक	र ो म ा न ् ट ि क
रोमी	र ो म ी
रोयल	र ो य ल
रोल	र ो ल
रोलप्लेइङ	र ो ल प ् ल े इ ङ
रोलमा	र ो ल म ा
रौँमा	र ौ ँ म ा
र्	र ्
लउन्जको	ल उ न ् ज क ो
लकहिडमार्टिन	ल क ह ि ड म ा र ् ट ि न
लक्जमबर्गको	ल क ् ज म ब र ् ग क ो
लक्षण	ल क ् ष ण
लक्ष्मी	ल क ् ष ् म ी
लक्ष्मीले	ल क ् ष ् म ी ल े
लगतै	ल ग त ै
लगभग	ल ग भ ग
लगाइएको	ल ग ा इ ए क ो
लगाउँथे	ल ग ा उ ँ थ े
लगाउन	ल ग ा उ न
लगाउनुपर्छ	ल ग ा उ न ु प र ् छ
लगाउने	ल ग ा उ न े
लगाएको	ल ग ा ए क ो
लगाएतका	ल ग ा ए त क ा
लगातार	ल ग ा त ा र
लगानी	ल ग ा न ी
लगायत	ल ग ा य त
लगायतका	ल ग ा य त क ा
लगायतले	ल ग ा य त ल े
लगेर	ल ग े र
लग्जरी	ल ग ् ज र ी
लग्यो	ल ग ् य ो
लडाइमा	ल ड ा इ म ा
लडाकु	ल ड ा क ु
लन्डन	ल न ् ड न
लन्डनको	ल न ् ड न क ो
लमजुङको	ल म ज ु ङ क ो
लम्बाई	ल म ् ब ा ई
लरेन्स	ल र े न ् स
ललित	ल ल ि त
ललितपुर	ल ल ि त प ु र
ललितपुरको	ल ल ि त प ु र क ो
ललितपुरले	ल ल ि त प ु र ल े
लवजमा	ल व ज म ा
लस	ल स
लसी	ल स ी
लसीका	ल स ी क ा
लाइनमा	ल ा इ न म ा
लाइनमार्फत	ल ा इ न म ा र ् फ त
लाइन्स	ल ा इ न ् स
लाइफ	ल ा इ फ
लाओस	ल ा ओ स
लाख	ल ा ख
लाखेनाचको	ल ा ख े न ा च क ो
लाखौँ	ल ा ख ौ ँ
लागि	ल ा ग ि
लागिएको	ल ा ग ि ए क ो
लागिरहेको	ल ा ग ि र ह े क ो
लागु	ल ा ग ु
लागू	ल ा ग ू
लागे	ल ा ग े
लागेका	ल ा ग े क ा
लागेको	ल ा ग े क ो
लागेपछि	ल ा ग े प छ ि
लाग्छ	ल ा ग ् छ
लाग्छु	ल ा ग ् छ ु
लाग्दछ	ल ा ग ् द छ
लाग्दा	ल ा ग ् द ा
लाग्दैन	ल ा ग ् द ै न
लाग्न	ल ा ग ् न
लाग्नाले	ल ा ग ् न ा ल े
लाग्यो	ल ा ग ् य ो
लाजिम्पाटमा	ल ा ज ि म ् प ा ट म ा
लाटभिया	ल ा ट भ ि य ा
लातभियाई	ल ा त भ ि य ा ई
लाब्राडोरको	ल ा ब ् र ा ड ो र क ो
लाभदायक	ल ा भ द ा य क
लाभदायी	ल ा भ द ा य ी
लाभा	ल ा भ ा
लाम	ल ा म
लामाले	ल ा म ा ल े
लामिछाने	ल ा म ि छ ा न े
लामो	ल ा म ो
लामोदूरी	ल ा म ो द ू र ी
लाम्पुर	ल ा म ् प ु र
लायन्स	ल ा य न ् स
लालचन्द्र	ल ा ल च न ् द ् र
लालबहादुर	ल ा ल ब ह ा द ु र
लालसिंह	ल ा ल स ि ं ह
लाहानबाट	ल ा ह ा न ब ा ट
लिइन्छ	ल ि इ न ् छ
लिए	ल ि ए
लिएका	ल ि ए क ा
लिएको	ल ि ए क ो
लिएर	ल ि ए र
लिको	ल ि क ो
लिखित	ल ि ख ि त
लिखू	ल ि ख ू
लिग	ल ि ग
लिङद्वारा	ल ि ङ द ् व ा र ा
लिङ्कट्री	ल ि ङ ् क ट ् र ी
लिङ्कन	ल ि ङ ् क न
लिङ्गो	ल ि ङ ् ग ो
लिच्छवि	ल ि च ् छ व ि
लिच्छविभन्दा	ल ि च ् छ व ि भ न ् द ा
लिजेन्ड	ल ि ज े न ् ड
लिटल	ल ि ट ल
लिथुआनिया	ल ि थ ु आ न ि य ा
लिथुआनियाको	ल ि थ ु आ न ि य ा क ो
लिथुआनियारूस	ल ि थ ु आ न ि य ा र ू स
लिथुवानिया	ल ि थ ु व ा न ि य ा
लिन	ल ि न
लिनका	ल ि न क ा
लिनक्स	ल ि न क ् स
लिनुभयो	ल ि न ु भ य ो
लिनुहुन्छ	ल ि न ु ह ु न ् छ
लिनुहोस्	ल ि न ु ह ो स ्
लिने	ल ि न े
लिपफ्रग	ल ि प फ ् र ग
लिपि	ल ि प ि
लिबर्टी	ल ि ब र ् ट ी
लिभरपुलमा	ल ि भ र प ु ल म ा
लिमा	ल ि म ा
लिमिटेड	ल ि म ि ट े ड
लिमिटेडको	ल ि म ि ट े ड क ो
लिमिटेडलाई	ल ि म ि ट े ड ल ा ई
लिमिटेडले	ल ि म ि ट े ड ल े
लिम्बु	ल ि म ् ब ु
लिम्बुद्वारा	ल ि म ् ब ु द ् व ा र ा
लिम्बुवान	ल ि म ् ब ु व ा न
लिम्बुहरूको	ल ि म ् ब ु ह र ू क ो
लियर	ल ि य र
लियाओ	ल ि य ा ओ
लियोन	ल ि य ो न
लियोनको	ल ि य ो न क ो
लियोनमा	ल ि य ो न म ा
लिसिपसले	ल ि स ि प स ल े
लुइटेल	ल ु इ ट े ल
लुक्ला	ल ु क ् ल ा
लुगाहरू	ल ु ग ा ह र ू
लुप्त	ल ु प ् त
लुम्बिनी	ल ु म ् ब ि न ी
लुम्बिनीमा	ल ु म ् ब ि न ी म ा
लुम्ले	ल ु म ् ल े
ले	ल े
लेइ	ल े इ
लेक	ल े क
लेखक	ल े ख क
लेखकको	ल े ख क क ो
लेखनाथ	ल े ख न ा थ
लेखमा	ल े ख म ा
लेखिए	ल े ख ि ए
लेखिएको	ल े ख ि ए क ो
लेखेको	ल े ख े क ो
लेख्दछन्	ल े ख ् द छ न ्
लेख्नु	ल े ख ् न ु
लेजर	ल े ज र
लेडिज	ल े ड ि ज
लेनदेन	ल े न द े न
लेनरी	ल े न र ी
लेन्ट	ल े न ् ट
लेलिनग्राड	ल े ल ि न ग ् र ा ड
लैजाँदैछन्	ल ै ज ा ँ द ै छ न ्
लैजान	ल ै ज ा न
लोअर	ल ो अ र
लोक	ल ो क
लोकगायक	ल ो क ग ा य क
लोकगीत	ल ो क ग ी त
लोकतान्त्रिक	ल ो क त ा न ् त ् र ि क
लोकप्रिय	ल ो क प ् र ि य
लोकप्रियता	ल ो क प ् र ि य त ा
लोकप्रियतालाई	ल ो क प ् र ि य त ा ल ा ई
लोकमार्ग	ल ो क म ा र ् ग
लोकराज	ल ो क र ा ज
लोकिङ	ल ो क ि ङ
लोखर्के	ल ो ख र ् क े
लोखर्केको	ल ो ख र ् क े क ो
लोगारिदमिक	ल ो ग ा र ि द म ि क
लोप	ल ो प
लोवेज	ल ो व े ज
लोहाकोटी	ल ो ह ा क ो ट ी
लौका	ल ौ क ा
ल्याउन	ल ् य ा उ न
ल्याएका	ल ् य ा ए क ा
ल्याएको	ल ् य ा ए क ो
ल्याटिन	ल ् य ा ट ि न
ल्यायो	ल ् य ा य ो
वंश	व ं श
वंशका	व ं श क ा
वंशको	व ं श क ो
वंशाणुविदहरूले	व ं श ा ण ु व ि द ह र ू ल े
वंशावलीमा	व ं श ा व ल ी म ा
वंशावलीहरूमा	व ं श ा व ल ी ह र ू म ा
वंशी	व ं श ी
वकिल	व क ि ल
वक्ताको	व क ् त ा क ो
वजन	व ज न
वटा	व ट ा
वटासम्म	व ट ा स म ् म
वडा	व ड ा
वडामा	व ड ा म ा
वधको	व ध क ो
वन	व न
वनकाग	व न क ा ग
वनस्पति	व न स ् प त ि
वनस्पतिविज्ञ	व न स ् प त ि व ि ज ् ञ
वनहरूले	व न ह र ू ल े
वन्यजन्तु	व न ् य ज न ् त ु
वन्यजन्य	व न ् य ज न ् य
वर	व र
वराह	व र ा ह
वरिपरि	व र ि प र ि
वरिष्ठ	व र ि ष ् ठ
वर्ग	व र ् ग
वर्गको	व र ् ग क ो
वर्गमा	व र ् ग म ा
वर्गीकरण	व र ् ग ी क र ण
वर्गीकरणमा	व र ् ग ी क र ण म ा
वर्डवाइड	व र ् ड व ा इ ड
वर्ण	व र ् ण
वर्तमान	व र ् त म ा न
वर्तमानमा	व र ् त म ा न म ा
वर्नमा	व र ् न म ा
वर्ल्ड	व र ् ल ् ड
वर्ष	व र ् ष
वर्षका	व र ् ष क ा
वर्षको	व र ् ष क ो
वर्षदेखि	व र ् ष द े ख ि
वर्षपछि	व र ् ष प छ ि
वर्षभरि	व र ् ष भ र ि
वर्षमा	व र ् ष म ा
वर्षमै	व र ् ष म ै
वर्षसम्म	व र ् ष स म ् म
वर्षा	व र ् ष ा
वर्षीय	व र ् ष ी य
वर्षीया	व र ् ष ी य ा
वर्षे	व र ् ष े
वल्ट	व ल ् ट
वल्लो	व ल ् ल ो
वस्	व स ्
वस्तु	व स ् त ु
वस्तुत	व स ् त ु त
वस्तुहरू	व स ् त ु ह र ू
वस्तुहरूको	व स ् त ु ह र ू क ो
वहन	व ह न
वा	व ा
वाइटुक	व ा इ ट ु क
वाणिज्य	व ा ण ि ज ् य
वातावरणमा	व ा त ा व र ण म ा
वारपार	व ा र प ा र
वारेन	व ा र े न
वार्ता	व ा र ् त ा
वार्ताका	व ा र ् त ा क ा
वार्नर	व ा र ् न र
वार्षिक	व ा र ् ष ि क
वार्षिकी	व ा र ् ष ि क ी
वार्षिकोत्सव	व ा र ् ष ि क ो त ् स व
वार्स	व ा र ् स
वार्सेल्स	व ा र ् स े ल ् स
वालग्रिन	व ा ल ग ् र ि न
वालमार्ट	व ा ल म ा र ् ट
वालिङ्बजार	व ा ल ि ङ ् ब ज ा र
वाल्मीकि	व ा ल ् म ी क ि
वाषिर्कोत्सवमा	व ा ष ि र ् क ो त ् स व म ा
वास	व ा स
वासिङटन	व ा स ि ङ ट न
वासिङ्टन	व ा स ि ङ ् ट न
वासिङ्टनको	व ा स ि ङ ् ट न क ो
वासुदेव	व ा स ु द े व
वास्तवमै	व ा स ् त व म ै
वास्तविकता	व ा स ् त व ि क त ा
वाहक	व ा ह क
वाहन	व ा ह न
वाहिद	व ा ह ि द
वि	व ि
विकल्प	व ि क ल ् प
विकसित	व ि क स ि त
विकाश	व ि क ा श
विकास	व ि क ा स
विकासका	व ि क ा स क ा
विकासको	व ि क ा स क ो
विकासक्षेत्रको	व ि क ा स क ् ष े त ् र क ो
विकासमा	व ि क ा स म ा
विकासले	व ि क ा स ल े
विकासित	व ि क ा स ि त
विकि	व ि क ि
विकिपिडिया	व ि क ि प ि ड ि य ा
विकिमिडिया	व ि क ि म ि ड ि य ा
विकिमीडियाद्वारा	व ि क ि म ी ड ि य ा द ् व ा र ा
विक्रम	व ि क ् र म
विगत	व ि ग त
विगतको	व ि ग त क ो
विगाहा	व ि ग ा ह ा
विचित्रका	व ि च ि त ् र क ा
विचित्रको	व ि च ि त ् र क ो
विजय	व ि ज य
विजयपुर	व ि ज य प ु र
विजयादशमीभर	व ि ज य ा द श म ी भ र
विजयी	व ि ज य ी
विज्ञान	व ि ज ् ञ ा न
विज्ञानकल्पना	व ि ज ् ञ ा न क ल ् प न ा
विज्ञानको	व ि ज ् ञ ा न क ो
विज्ञानमानविकी	व ि ज ् ञ ा न म ा न व ि क ी
विज्ञानी	व ि ज ् ञ ा न ी
वितरण	व ि त र ण
वित्तीय	व ि त ् त ी य
विदेश	व ि द े श
विदेशी	व ि द े श ी
विद्धान	व ि द ् ध ा न
विद्धानहरूको	व ि द ् ध ा न ह र ू क ो
विद्यमान	व ि द ् य म ा न
विद्या	व ि द ् य ा
विद्यामन्दिर	व ि द ् य ा म न ् द ि र
विद्यार्थीका	व ि द ् य ा र ् थ ी क ा
विद्यार्थीको	व ि द ् य ा र ् थ ी क ो
विद्यार्थीहरूका	व ि द ् य ा र ् थ ी ह र ू क ा
विद्यार्थीहरूलाई	व ि द ् य ा र ् थ ी ह र ू ल ा ई
विद्यालय	व ि द ् य ा ल य
विद्यालयबाट	व ि द ् य ा ल य ब ा ट
विद्यालयमा	व ि द ् य ा ल य म ा
विद्यालयलाई	व ि द ् य ा ल य ल ा ई
विद्यालयले	व ि द ् य ा ल य ल े
विद्यालयहरूका	व ि द ् य ा ल य ह र ू क ा
विद्यालयहरूमा	व ि द ् य ा ल य ह र ू म ा
विद्युत	व ि द ् य ु त
विद्युतिकरण	व ि द ् य ु त ि क र ण
विद्युतीय	व ि द ् य ु त ी य
विद्वान	व ि द ् व ा न
विधा	व ि ध ा
विनाशकारी	व ि न ा श क ा र ी
विनास	व ि न ा स
विनासको	व ि न ा स क ो
विनोद	व ि न ो द
विन्डोज	व ि न ् ड ो ज
विन्डोजको	व ि न ् ड ो ज क ो
विन्दु	व ि न ् द ु
विन्दुको	व ि न ् द ु क ो
विपना	व ि प न ा
विपी	व ि प ी
विभन्नता	व ि भ न ् न त ा
विभाग	व ि भ ा ग
विभागमा	व ि भ ा ग म ा
विभागहरू	व ि भ ा ग ह र ू
विभाजन	व ि भ ा ज न
विभिन्न	व ि भ ि न ् न
विमान	व ि म ा न
विमानलाई	व ि म ा न ल ा ई
विमानस्थल	व ि म ा न स ् थ ल
विमानस्थलबाट	व ि म ा न स ् थ ल ब ा ट
विमानस्थलमा	व ि म ा न स ् थ ल म ा
विमानहरूको	व ि म ा न ह र ू क ो
वियोगको	व ि य ो ग क ो
विरहीचरी	व ि र ह ी च र ी
विराज	व ि र ा ज
विराट	व ि र ा ट
विराटनगरमा	व ि र ा ट न ग र म ा
विरूपाक्ष	व ि र ू प ा क ् ष
विरोध	व ि र ो ध
विलियम	व ि ल ि य म
विलुप्त	व ि ल ु प ् त
विलेम	व ि ल े म
विवरण	व ि व र ण
विवरणमा	व ि व र ण म ा
विवरणहरु	व ि व र ण ह र ु
विवरणहरू	व ि व र ण ह र ू
विवरणहरूका	व ि व र ण ह र ू क ा
विवाद	व ि व ा द
विवादलाई	व ि व ा द ल ा ई
विवाह	व ि व ा ह
विवाहको	व ि व ा ह क ो
विविध	व ि व ि ध
विविधता	व ि व ि ध त ा
विशाल	व ि श ा ल
विशेष	व ि श े ष
विशेषज्ञ	व ि श े ष ज ् ञ
विशेषज्ञलाई	व ि श े ष ज ् ञ ल ा ई
विशेषता	व ि श े ष त ा
विश्मा	व ि श ् म ा
विश्लेषकको	व ि श ् ल े ष क क ो
विश्लेषकले	व ि श ् ल े ष क ल े
विश्लेषण	व ि श ् ल े ष ण
विश्व	व ि श ् व
विश्वकर्मा	व ि श ् व क र ् म ा
विश्वका	व ि श ् व क ा
विश्वकै	व ि श ् व क ै
विश्वको	व ि श ् व क ो
विश्वचर्चित	व ि श ् व च र ् च ि त
विश्वभर	व ि श ् व भ र
विश्वभरका	व ि श ् व भ र क ा
विश्वमा	व ि श ् व म ा
विश्वमै	व ि श ् व म ै
विश्वयुद्ध	व ि श ् व य ु द ् ध
विश्वयुद्धको	व ि श ् व य ु द ् ध क ो
विश्वविद्यालय	व ि श ् व व ि द ् य ा ल य
विश्वविद्यालयबाट	व ि श ् व व ि द ् य ा ल य ब ा ट
विश्वविद्यालयले	व ि श ् व व ि द ् य ा ल य ल े
विश्वव्यापी	व ि श ् व व ् य ा प ी
विश्वास	व ि श ् व ा स
विश्वासनीयता	व ि श ् व ा स न ी य त ा
विषय	व ि ष य
विषयक	व ि ष य क
विषयमा	व ि ष य म ा
विषयलाई	व ि ष य ल ा ई
विषयहरूमा	व ि ष य ह र ू म ा
विष्णु	व ि ष ् ण ु
विष्णुकुमारी	व ि ष ् ण ु क ु म ा र ी
विसं	व ि स ं
विसर्जन	व ि स र ् ज न
विस्तार	व ि स ् त ा र
विस्तारको	व ि स ् त ा र क ो
विस्तारमा	व ि स ् त ा र म ा
विस्तृत	व ि स ् त ृ त
विस्ल्याम	व ि स ् ल ् य ा म
वीपी	व ी प ी
वीर	व ी र
वीरगञ्ज	व ी र ग ञ ् ज
वीरेन्द्र	व ी र े न ् द ् र
वीरेन्द्रनगर	व ी र े न ् द ् र न ग र
वुड्पेकर	व ु ड ् प े क र
वृक्ष	व ृ क ् ष
वृक्षहरूको	व ृ क ् ष ह र ू क ो
वृत्ताकार	व ृ त ् त ा क ा र
वे	व े
वेब	व े ब
वेबमा	व े ब म ा
वेबसाइट	व े ब स ा इ ट
वेबसाइटसँग	व े ब स ा इ ट स ँ ग
वेलपोइन्टमा	व े ल प ो इ न ् ट म ा
वेलिङ्टन	व े ल ि ङ ् ट न
वेल्स	व े ल ् स
वेल्समा	व े ल ् स म ा
वेश्यावृत्तिमा	व े श ् य ा व ृ त ् त ि म ा
वेस्टफेलिया	व े स ् ट फ े ल ि य ा
वेस्टफेलियाकको	व े स ् ट फ े ल ि य ा क क ो
वेस्टमिनिस्टरमा	व े स ् ट म ि न ि स ् ट र म ा
वेस्टर्न	व े स ् ट र ् न
वैचारिक	व ै च ा र ि क
वैज्ञानिक	व ै ज ् ञ ा न ि क
वैज्ञानिकहरू	व ै ज ् ञ ा न ि क ह र ू
वैज्ञानिकहरूको	व ै ज ् ञ ा न ि क ह र ू क ो
वैदिक	व ै द ि क
वैदेशिक	व ै द े श ि क
वैद्य	व ै द ् य
वैशाख	व ै श ा ख
वैश्विक	व ै श ् व ि क
व्यक्त	व ् य क ् त
व्यक्ति	व ् य क ् त ि
व्यक्तिगत	व ् य क ् त ि ग त
व्यक्तित्वको	व ् य क ् त ि त ् व क ो
व्यक्तिलाई	व ् य क ् त ि ल ा ई
व्यक्तिले	व ् य क ् त ि ल े
व्यक्तिहरू	व ् य क ् त ि ह र ू
व्यक्तिहरूको	व ् य क ् त ि ह र ू क ो
व्यपारिक	व ् य प ा र ि क
व्यवसाय	व ् य व स ा य
व्यवसायका	व ् य व स ा य क ा
व्यवसायमा	व ् य व स ा य म ा
व्यवसायी	व ् य व स ा य ी
व्यवस्था	व ् य व स ् थ ा
व्यवस्थाको	व ् य व स ् थ ा क ो
व्यवस्थापक	व ् य व स ् थ ा प क
व्यवस्थापन	व ् य व स ् थ ा प न
व्यवस्थापनको	व ् य व स ् थ ा प न क ो
व्यवस्थामा	व ् य व स ् थ ा म ा
व्यवस्थामाथि	व ् य व स ् थ ा म ा थ ि
व्यवस्थालाई	व ् य व स ् थ ा ल ा ई
व्यवहारिकता	व ् य व ह ा र ि क त ा
व्याख्या	व ् य ा ख ् य ा
व्यापक	व ् य ा प क
व्यापार	व ् य ा प ा र
व्यापारिक	व ् य ा प ा र ि क
व्यावसायिक	व ् य ा व स ा य ि क
व्यावसायिकको	व ् य ा व स ा य ि क क ो
व्यास	व ् य ा स
व्यासमा	व ् य ा स म ा
व्युत्पन्न	व ् य ु त ् प न ् न
व्युर्टेबर्गमा	व ् य ु र ् ट े ब र ् ग म ा
व्रत	व ् र त
व्हाइट	व ् ह ा इ ट
शंकर	श ं क र
शक्ति	श क ् त ि
शङ्कर	श ङ ् क र
शङ्करबाट	श ङ ् क र ब ा ट
शताब्दी	श त ा ब ् द ी
शताब्दीका	श त ा ब ् द ी क ा
शताब्दीको	श त ा ब ् द ी क ो
शताब्दीमा	श त ा ब ् द ी म ा
शताब्दीयौँ	श त ा ब ् द ी य ौ ँ
शताब्दीयौँदेखि	श त ा ब ् द ी य ौ ँ द े ख ि
शनिवार	श न ि व ा र
शब्द	श ब ् द
शब्दको	श ब ् द क ो
शब्दचित्रमा	श ब ् द च ि त ् र म ा
शब्दले	श ब ् द ल े
शब्दहरूको	श ब ् द ह र ू क ो
शम्भुको	श म ् भ ु क ो
शरणको	श र ण क ो
शरद	श र द
शरीर	श र ी र
शरीरभर	श र ी र भ र
शर्मा	श र ् म ा
शर्माको	श र ् म ा क ो
शर्माद्वारा	श र ् म ा द ् व ा र ा
शर्मालगायतको	श र ् म ा ल ग ा य त क ो
शर्माले	श र ् म ा ल े
शलोन	श ल ो न
शल्यक्रिया	श ल ् य क ् र ि य ा
शहर	श ह र
शहरमा	श ह र म ा
शहीदस्मृति	श ह ी द स ् म ृ त ि
शाक्य	श ा क ् य
शाखा	श ा ख ा
शाखाको	श ा ख ा क ो
शाखाहरू	श ा ख ा ह र ू
शाखाहरूमा	श ा ख ा ह र ू म ा
शान्ति	श ा न ् त ि
शान्तिको	श ा न ् त ि क ो
शान्तिपूर्ण	श ा न ् त ि प ू र ् ण
शारदा	श ा र द ा
शारीरिक	श ा र ी र ि क
शासक	श ा स क
शासकलाई	श ा स क ल ा ई
शासकले	श ा स क ल े
शासकहरूले	श ा स क ह र ू ल े
शासन	श ा स न
शासित	श ा स ि त
शास्त्री	श ा स ् त ् र ी
शाह	श ा ह
शाहका	श ा ह क ा
शाहकै	श ा ह क ै
शाहको	श ा ह क ो
शाहद्वारा	श ा ह द ् व ा र ा
शाहले	श ा ह ल े
शाहवंशी	श ा ह व ं श ी
शाहा	श ा ह ा
शाही	श ा ह ी
शिक्षक	श ि क ् ष क
शिक्षकको	श ि क ् ष क क ो
शिक्षण	श ि क ् ष ण
शिक्षा	श ि क ् ष ा
शिक्षालाई	श ि क ् ष ा ल ा ई
शिक्षाशास्त्रमा	श ि क ् ष ा श ा स ् त ् र म ा
शिक्षित	श ि क ् ष ि त
शिखर	श ि ख र
शितोष्ण	श ि त ो ष ् ण
शिलन्यास	श ि ल न ् य ा स
शिव	श ि व
शिशिर	श ि श ि र
शिशु	श ि श ु
शीघ्रतम	श ी घ ् र त म
शीतकालीन	श ी त क ा ल ी न
शीतल	श ी त ल
शीरमेमोरीयल	श ी र म े म ो र ी य ल
शीर्ष	श ी र ् ष
शीर्षक	श ी र ् ष क
शुक्रवार	श ु क ् र व ा र
शुक्ल	श ु क ् ल
शुक्लयजुर्वेद	श ु क ् ल य ज ु र ् व े द
शुद्ध	श ु द ् ध
शुभअवसरमा	श ु भ अ व स र म ा
शुसिला	श ु स ि ल ा
शेक्सपियरद्वारा	श े क ् स प ि य र द ् व ा र ा
शेखरमानन्धर	श े ख र म ा न न ् ध र
शेरेचनको	श े र े च न क ो
शेर्पा	श े र ् प ा
शेषको	श े ष क ो
शैक्षिक	श ै क ् ष ि क
शैया	श ै य ा
शैली	श ै ल ी
शैलीमा	श ै ल ी म ा
शैलेन्द्र	श ै ल े न ् द ् र
शोक	श ो क
शोषित	श ो ष ि त
शौखिन	श ौ ख ि न
श्रमिक	श ् र म ि क
श्री	श ् र ी
श्रीकृष्ण	श ् र ी क ृ ष ् ण
श्रीधर	श ् र ी ध र
श्रीमती	श ् र ी म त ी
श्रीमान्	श ् र ी म ा न ्
श्रीलङ्कामा	श ् र ी ल ङ ् क ा म ा
श्रीशा	श ् र ी श ा
श्रृंखला	श ् र ृ ं ख ल ा
श्रृंखलामा	श ् र ृ ं ख ल ा म ा
श्रृंखलाहरूको	श ् र ृ ं ख ल ा ह र ू क ो
श्रृङ्खला	श ् र ृ ङ ् ख ल ा
श्रृङ्गार	श ् र ृ ङ ् ग ा र
श्रेणी	श ् र े ण ी
श्रेणीको	श ् र े ण ी क ो
श्रेणीमा	श ् र े ण ी म ा
श्रेष्ठ	श ् र े ष ् ठ
श्रेष्ठसँग	श ् र े ष ् ठ स ँ ग
श्रोतव्यक्ति	श ् र ो त व ् य क ् त ि
श्रोतामाझ	श ् र ो त ा म ा झ
सँगालो	स ँ ग ा ल ो
सँगै	स ँ ग ै
सँधै	स ँ ध ै
संकुचन	स ं क ु च न
संक्रमण	स ं क ् र म ण
संक्रामक	स ं क ् र ा म क
संगमकालीन	स ं ग म क ा ल ी न
संगमतन्त्र	स ं ग म त न ् त ् र
संगममा	स ं ग म म ा
संगीतकार	स ं ग ी त क ा र
संगीता	स ं ग ी त ा
संग्रहालय	स ं ग ् र ह ा ल य
संग्रामले	स ं ग ् र ा म ल े
संघ	स ं घ
संघको	स ं घ क ो
संयम	स ं य म
संयुक्त	स ं य ु क ् त
संयोजक	स ं य ो ज क
संरक्षक	स ं र क ् ष क
संरचना	स ं र च न ा
संरचनाको	स ं र च न ा क ो
संरचनात्मक	स ं र च न ा त ् म क
संरचनामा	स ं र च न ा म ा
संलग्न	स ं ल ग ् न
संवत	स ं व त
संवत्	स ं व त ्
संविधान	स ं व ि ध ा न
संसदीय	स ं स द ी य
संसाधन	स ं स ा ध न
संसारकै	स ं स ा र क ै
संसारको	स ं स ा र क ो
संसारभर	स ं स ा र भ र
संसारभरि	स ं स ा र भ र ि
संसारभरी	स ं स ा र भ र ी
संस्करण	स ं स ् क र ण
संस्कार	स ं स ् क ा र
संस्कृत	स ं स ् क ृ त
संस्कृतमा	स ं स ् क ृ त म ा
संस्कृति	स ं स ् क ृ त ि
संस्कृतिका	स ं स ् क ृ त ि क ा
संस्कृतिको	स ं स ् क ृ त ि क ो
संस्कृतिहरू	स ं स ् क ृ त ि ह र ू
संस्कृतिहरूका	स ं स ् क ृ त ि ह र ू क ा
संस्था	स ं स ् थ ा
संस्थापक	स ं स ् थ ा प क
संस्थामा	स ं स ् थ ा म ा
संस्थाले	स ं स ् थ ा ल े
संस्थाहरूले	स ं स ् थ ा ह र ू ल े
संस्मरणात्मक	स ं स ् म र ण ा त ् म क
सकिँदैन	स क ि ँ द ै न
सकिएन	स क ि ए न
सकिने	स क ि न े
सकिन्छ	स क ि न ् छ
सकिरहेका	स क ि र ह े क ा
सकेको	स क े क ो
सकेन	स क े न
सक्छ	स क ् छ
सक्छन्	स क ् छ न ्
सक्दछौं	स क ् द छ ौ ं
सक्दथे	स क ् द थ े
सक्नुपर्छ	स क ् न ु प र ् छ
सक्नुहुन्छ	स क ् न ु ह ु न ् छ
सक्ने	स क ् न े
सक्रिय	स क ् र ि य
सक्रियतामा	स क ् र ि य त ा म ा
सक्सोनीको	स क ् स ो न ी क ो
सक्सोनीमा	स क ् स ो न ी म ा
सगंम	स ग ं म
सगरमाथा	स ग र म ा थ ा
सङ्कट	स ङ ् क ट
सङ्कटमा	स ङ ् क ट म ा
सङ्कलक	स ङ ् क ल क
सङ्कलित	स ङ ् क ल ि त
सङ्कुचन	स ङ ् क ु च न
सङ्कुचित	स ङ ् क ु च ि त
सङ्केत	स ङ ् क े त
सङ्खुवासभा	स ङ ् ख ु व ा स भ ा
सङ्खुवासभामा	स ङ ् ख ु व ा स भ ा म ा
सङ्ख्या	स ङ ् ख ् य ा
सङ्ख्याद्वारा	स ङ ् ख ् य ा द ् व ा र ा
सङ्ख्याभन्दा	स ङ ् ख ् य ा भ न ् द ा
सङ्ख्यामा	स ङ ् ख ् य ा म ा
सङ्गठनको	स ङ ् ग ठ न क ो
सङ्गठित	स ङ ् ग ठ ि त
सङ्गम	स ङ ् ग म
सङ्गितकार	स ङ ् ग ि त क ा र
सङ्गीत	स ङ ् ग ी त
सङ्गीतकार	स ङ ् ग ी त क ा र
सङ्गीतको	स ङ ् ग ी त क ो
सङ्गीतमा	स ङ ् ग ी त म ा
सङ्गीता	स ङ ् ग ी त ा
सङ्ग्रह	स ङ ् ग ् र ह
सङ्ग्रहालय	स ङ ् ग ् र ह ा ल य
सङ्घ	स ङ ् घ
सङ्घका	स ङ ् घ क ा
सङ्घको	स ङ ् घ क ो
सङ्घमा	स ङ ् घ म ा
सङ्घर्ष	स ङ ् घ र ् ष
सङ्घीय	स ङ ् घ ी य
सजाइएको	स ज ा इ ए क ो
सजाय	स ज ा य
सजिला	स ज ि ल ा
सजिलै	स ज ि ल ै
सजिलो	स ज ि ल ो
सज्जन	स ज ् ज न
सञ्चार	स ञ ् च ा र
सञ्चारकर्मी	स ञ ् च ा र क र ् म ी
सञ्चालक	स ञ ् च ा ल क
सञ्चालन	स ञ ् च ा ल न
सञ्चालनको	स ञ ् च ा ल न क ो
सञ्चालनमा	स ञ ् च ा ल न म ा
सञ्चालित	स ञ ् च ा ल ि त
सञ्चिता	स ञ ् च ि त ा
सञ्जाल	स ञ ् ज ा ल
सट्सट्ठी	स ट ् स ट ् ठ ी
सडक	स ड क
सडकको	स ड क क ो
सडकबाट	स ड क ब ा ट
सडकमा	स ड क म ा
सतलज	स त ल ज
सतहदेखि	स त ह द े ख ि
सताब्दी	स त ा ब ् द ी
सतासीमा	स त ा स ी म ा
सत्कार	स त ् क ा र
सत्चालिसमा	स त ् च ा ल ि स म ा
सत्तरी	स त ् त र ी
सत्तरीमा	स त ् त र ी म ा
सत्ताइस	स त ् त ा इ स
सत्ताइसौँ	स त ् त ा इ स ौ ँ
सत्तामा	स त ् त ा म ा
सत्तारूढ	स त ् त ा र ू ढ
सत्य	स त ् य
सत्यराज	स त ् य र ा ज
सत्र	स त ् र
सत्रौँ	स त ् र ौ ँ
सत्सट्ठीमा	स त ् स ट ् ठ ी म ा
सदनमा	स द न म ा
सदरमुकाम	स द र म ु क ा म
सदरमुकाममा	स द र म ु क ा म म ा
सदस्य	स द स ् य
सधैँ	स ध ै ँ
सन	स न
सनबर्ड	स न ब र ् ड
सनराइज	स न र ा इ ज
सन्	स न ्
सन्तान	स न ् त ा न
सन्तानब्बे	स न ् त ा न ब ् ब े
सन्तानब्बेमा	स न ् त ा न ब ् ब े म ा
सन्तुलन	स न ् त ु ल न
सन्तोष	स न ् त ो ष
सन्धिखर्क	स न ् ध ि ख र ् क
सन्धीखर्क	स न ् ध ी ख र ् क
सपमा	स प म ा
सपले	स प ल े
सपार्ने	स प ा र ् न े
सप्तगण्डकी	स प ् त ग ण ् ड क ी
सप्तम	स प ् त म
सप्तरी	स प ् त र ी
सप्लायर्स	स प ् ल ा य र ् स
सप्लायर्सले	स प ् ल ा य र ् स ल े
सप्लार्यसले	स प ् ल ा र ् य स ल े
सफल	स फ ल
सफलता	स फ ल त ा
सफा	स फ ा
सफाईका	स फ ा ई क ा
सफ्टनेपले	स फ ् ट न े प ल े
सफ्टवेयर	स फ ् ट व े य र
सबभन्दा	स ब भ न ् द ा
सबिता	स ब ि त ा
सबिन	स ब ि न
सबै	स ब ै
सबैका	स ब ै क ा
सबैकुरा	स ब ै क ु र ा
सबैको	स ब ै क ो
सबैभन्दा	स ब ै भ न ् द ा
सबैलाई	स ब ै ल ा ई
सबैले	स ब ै ल े
सभा	स भ ा
सभाका	स भ ा क ा
सभासद्	स भ ा स द ्
सभ्य	स भ ् य
सभ्यता	स भ ् य त ा
सभ्यताका	स भ ् य त ा क ा
सभ्यताको	स भ ् य त ा क ो
समकालीन	स म क ा ल ी न
समको	स म क ो
समझौता	स म झ ौ त ा
समतल	स म त ल
समथर	स म थ र
समय	स म य
समयको	स म य क ो
समयदेखि	स म य द े ख ि
समयभित्रै	स म य भ ि त ् र ै
समयमा	स म य म ा
समयमै	स म य म ै
समयावधिका	स म य ा व ध ि क ा
समयावधिमा	स म य ा व ध ि म ा
समर्थन	स म र ् थ न
समर्थित	स म र ् थ ि त
समवेदना	स म व े द न ा
समशितोष्णदेखि	स म श ि त ो ष ् ण द े ख ि
समष्टिको	स म ष ् ट ि क ो
समसामयिक	स म स ा म य ि क
समस्या	स म स ् य ा
समस्याहरूको	स म स ् य ा ह र ू क ो
समस्याहरूमाथि	स म स ् य ा ह र ू म ा थ ि
समस्याहरूलाई	स म स ् य ा ह र ू ल ा ई
समाचार	स म ा च ा र
समाज	स म ा ज
समाजकल्याणको	स म ा ज क ल ् य ा ण क ो
समाजको	स म ा ज क ो
समाजमा	स म ा ज म ा
समाजले	स म ा ज ल े
समाजवादमा	स म ा ज व ा द म ा
समाजवादी	स म ा ज व ा द ी
समाजसेवामा	स म ा ज स े व ा म ा
समाधान	स म ा ध ा न
समाधानहरू	स म ा ध ा न ह र ू
समानुपातिक	स म ा न ु प ा त ि क
समानुपातिकतर्फ	स म ा न ु प ा त ि क त र ् फ
समापन	स म ा प न
समाप्त	स म ा प ् त
समारा	स म ा र ा
समारोहका	स म ा र ो ह क ा
समारोहहरूमा	स म ा र ो ह ह र ू म ा
समाल	स म ा ल
समालोचक	स म ा ल ो च क
समावेश	स म ा व े श
समाहित	स म ा ह ि त
समिट	स म ि ट
समिति	स म ि त ि
समितिको	स म ि त ि क ो
समुदाय	स म ु द ा य
समुदायका	स म ु द ा य क ा
समुदायकै	स म ु द ा य क ै
समुदायमा	स म ु द ा य म ा
समुदायहरू	स म ु द ा य ह र ू
समुद्र	स म ु द ् र
समुद्रमा	स म ु द ् र म ा
समुद्री	स म ु द ् र ी
समूह	स म ू ह
समूहका	स म ू ह क ा
समूहको	स म ू ह क ो
समृद्ध	स म ृ द ् ध
समेटेर	स म े ट े र
समेत	स म े त
सम्झिइन्थ्यो	स म ् झ ि इ न ् थ ् य ो
सम्झिरहनु	स म ् झ ि र ह न ु
सम्झौता	स म ् झ ौ त ा
सम्पत्ति	स म ् प त ् त ि
सम्पत्तिको	स म ् प त ् त ि क ो
सम्पदा	स म ् प द ा
सम्पदाको	स म ् प द ा क ो
सम्पन्न	स म ् प न ् न
सम्पर्क	स म ् प र ् क
सम्पर्कमा	स म ् प र ् क म ा
सम्पादक	स म ् प ा द क
सम्पादन	स म ् प ा द न
सम्पादित	स म ् प ा द ि त
सम्पूर्ण	स म ् प ू र ् ण
सम्प्रदायसँग	स म ् प ् र द ा य स ँ ग
सम्बन्धन	स म ् ब न ् ध न
सम्बन्धमा	स म ् ब न ् ध म ा
सम्बन्धित	स म ् ब न ् ध ि त
सम्बन्धी	स म ् ब न ् ध ी
सम्भावना	स म ् भ ा व न ा
सम्भोज	स म ् भ ो ज
सम्म	स म ् म
सम्मका	स म ् म क ा
सम्ममा	स म ् म म ा
सम्मान	स म ् म ा न
सम्मेलन	स म ् म े ल न
सम्मेलनमा	स म ् म े ल न म ा
सम्राट	स म ् र ा ट
सम्वत्	स म ् व त ्
सम्वन्ध	स म ् व न ् ध
सम्वेदनशील	स म ् व े द न श ी ल
सय	स य
सरकार	स र क ा र
सरकारले	स र क ा र ल े
सरकारहरूले	स र क ा र ह र ू ल े
सरकारी	स र क ा र ी
सरदर	स र द र
सरदार	स र द ा र
सरल	स र ल
सरस्वती	स र स ् व त ी
सरी	स र ी
सरे	स र े
सरेको	स र े क ो
सर्किट	स र ् क ि ट
सर्जनसबाट	स र ् ज न स ब ा ट
सर्जरी	स र ् ज र ी
सर्तमा	स र ् त म ा
सर्ने	स र ् न े
सर्बियन	स र ् ब ि य न
सर्बियाली	स र ् ब ि य ा ल ी
सर्भिस	स र ् भ ि स
सर्भिसेज	स र ् भ ि स े ज
सर्भिसेजले	स र ् भ ि स े ज ल े
सर्लाही	स र ् ल ा ह ी
सर्लाहीमा	स र ् ल ा ह ी म ा
सर्वप्रथम	स र ् व प ् र थ म
सर्वसाधरणको	स र ् व स ा ध र ण क ो
सर्वसाधारणमा	स र ् व स ा ध ा र ण म ा
सर्वसाधारणलाई	स र ् व स ा ध ा र ण ल ा ई
सर्वसाधारणले	स र ् व स ा ध ा र ण ल े
सर्वाधिक	स र ् व ा ध ि क
सर्वेक्षणमा	स र ् व े क ् ष ण म ा
सर्वोच्च	स र ् व ो च ् च
सर्वोत्तम	स र ् व ो त ् त म
सलमन्सा	स ल म न ् स ा
सलुसन	स ल ु स न
सलुसन्सले	स ल ु स न ् स ल े
सल्यान	स ल ् य ा न
सल्लाह	स ल ् ल ा ह
सल्लाहकार	स ल ् ल ा ह क ा र
सवारी	स व ा र ी
सशस्त्र	स श स ् त ् र
ससानो	स स ा न ो
सस्केचेवान	स स ् क े च े व ा न
सस्ता	स स ् त ा
सहज	स ह ज
सहनशील	स ह न श ी ल
सहभागिता	स ह भ ा ग ि त ा
सहभागिताका	स ह भ ा ग ि त ा क ा
सहभागी	स ह भ ा ग ी
सहमति	स ह म त ि
सहयात्रामा	स ह य ा त ् र ा म ा
सहयोग	स ह य ो ग
सहयोगमा	स ह य ो ग म ा
सहयोगले	स ह य ो ग ल े
सहर	स ह र
सहरको	स ह र क ो
सहरबाट	स ह र ब ा ट
सहरमध्ये	स ह र म ध ् य े
सहरमा	स ह र म ा
सहरराज्य	स ह र र ा ज ् य
सहरसँगै	स ह र स ँ ग ै
सहरहरू	स ह र ह र ू
सहरहरूमध्ये	स ह र ह र ू म ध ् य े
सहरहरूमध्येको	स ह र ह र ू म ध ् य े क ो
सहरी	स ह र ी
सहायक	स ह ा य क
सहायता	स ह ा य त ा
सहित	स ह ि त
सहिद	स ह ि द
सहिदहरू	स ह ि द ह र ू
सही	स ह ी
साँझमा	स ा ँ झ म ा
साँस	स ा ँ स
साइकलिस्ट	स ा इ क ल ि स ् ट
साइगन	स ा इ ग न
साइप्रसका	स ा इ प ् र स क ा
साइप्रसको	स ा इ प ् र स क ो
साइबेरियामा	स ा इ ब े र ि य ा म ा
साउथ	स ा उ थ
साउदको	स ा उ द क ो
साउदले	स ा उ द ल े
साउदी	स ा उ द ी
साक्षत	स ा क ् ष त
साक्स	स ा क ् स
सागपात	स ा ग प ा त
सागर	स ा ग र
सागरमा	स ा ग र म ा
साघुरो	स ा घ ु र ो
साङ	स ा ङ
साङ्गीतिक	स ा ङ ् ग ी त ि क
साङ्घाइ	स ा ङ ् घ ा इ
साझा	स ा झ ा
साझेदारहरूलाई	स ा झ े द ा र ह र ू ल ा ई
साझेदारी	स ा झ े द ा र ी
साठी	स ा ठ ी
सात	स ा त
सातमा	स ा त म ा
सातिभाको	स ा त ि भ ा क ो
सातौँ	स ा त ौ ँ
साथ	स ा थ
साथमा	स ा थ म ा
साथै	स ा थ ै
साद्री	स ा द ् र ी
साधन	स ा ध न
साधनहरू	स ा ध न ह र ू
साधनहरूका	स ा ध न ह र ू क ा
साधारण	स ा ध ा र ण
सान	स ा न
सानक्सीमा	स ा न क ् स ी म ा
साना	स ा न ा
सानाठुला	स ा न ा ठ ु ल ा
सानालाई	स ा न ा ल ा ई
सानिमा	स ा न ि म ा
सानी	स ा न ी
सानैदेखि	स ा न ै द े ख ि
सानो	स ा न ो
सापकोटाकी	स ा प क ो ट ा क ी
सामग्री	स ा म ग ् र ी
सामग्रीका	स ा म ग ् र ी क ा
सामग्रीहरू	स ा म ग ् र ी ह र ू
सामग्रीहरूको	स ा म ग ् र ी ह र ू क ो
सामाग्री	स ा म ा ग ् र ी
सामाजिक	स ा म ा ज ि क
सामान	स ा म ा न
सामान्य	स ा म ा न ् य
सामान्यतः	स ा म ा न ् य त ः
सामान्यतया	स ा म ा न ् य त य ा
सामुदायिक	स ा म ु द ा य ि क
सामेल	स ा म े ल
साम्राज्य	स ा म ् र ा ज ् य
साम्राज्यको	स ा म ् र ा ज ् य क ो
साम्राज्यिक	स ा म ् र ा ज ् य ि क
सारस	स ा र स
सारा	स ा र ा
सारेको	स ा र े क ो
सार्क	स ा र ् क
सार्नुभयो	स ा र ् न ु भ य ो
सार्वजनिक	स ा र ् व ज न ि क
सार्वभौम	स ा र ् व भ ौ म
साल	स ा ल
सालक	स ा ल क
सालको	स ा ल क ो
सालदेखि	स ा ल द े ख ि
सालमा	स ा ल म ा
साविक	स ा व ि क
सास	स ा स
साहना	स ा ह न ा
साहित्य	स ा ह ि त ् य
साहित्यकार	स ा ह ि त ् य क ा र
साहित्यकारहरूमा	स ा ह ि त ् य क ा र ह र ू म ा
साहित्यको	स ा ह ि त ् य क ो
साहित्यमा	स ा ह ि त ् य म ा
साहित्यिक	स ा ह ि त ् य ि क
साह्रै	स ा ह ् र ै
सिँचाई	स ि ँ च ा ई
सिं	स ि ं
सिंङको	स ि ं ङ क ो
सिंह	स ि ं ह
सिंहको	स ि ं ह क ो
सिंहलाई	स ि ं ह ल ा ई
सिंहले	स ि ं ह ल े
सिएनएनको	स ि ए न ए न क ो
सिकागो	स ि क ा ग ो
सिकार	स ि क ा र
सिग्देल	स ि ग ् द े ल
सिग्नल	स ि ग ् न ल
सिग्नलहरूको	स ि ग ् न ल ह र ू क ो
सिग्ना	स ि ग ् न ा
सिग्मा	स ि ग ् म ा
सिङ	स ि ङ
सिङ्गापुर	स ि ङ ् ग ा प ु र
सिजन	स ि ज न
सिटिग्रुप	स ि ट ि ग ् र ु प
सिटी	स ि ट ी
सिटीका	स ि ट ी क ा
सिटीमा	स ि ट ी म ा
सिटौला	स ि ट ौ ल ा
सिडनी	स ि ड न ी
सिदार्थनगरमा	स ि द ा र ् थ न ग र म ा
सिद्ध	स ि द ् ध
सिद्धनारायण	स ि द ् ध न ा र ा य ण
सिद्धान्त	स ि द ् ध ा न ् त
सिद्धान्तहरूलाई	स ि द ् ध ा न ् त ह र ू ल ा ई
सिद्धार्थ	स ि द ् ध ा र ् थ
सिद्धार्थनगर	स ि द ् ध ा र ् थ न ग र
सिद्धि	स ि द ् ध ि
सिद्धिचरण	स ि द ् ध ि च र ण
सिद्धिथुम्का	स ि द ् ध ि थ ु म ् क ा
सिधा	स ि ध ा
सिधै	स ि ध ै
सिनफुएगोस	स ि न फ ु ए ग ो स
सिनेकलाकार	स ि न े क ल ा क ा र
सिनेटर	स ि न े ट र
सिनेनगरमा	स ि न े न ग र म ा
सिनेनगरीमा	स ि न े न ग र ी म ा
सिनेमा	स ि न े म ा
सिनोतिबेतन	स ि न ो त ि ब े त न
सिन्दुर	स ि न ् द ु र
सिन्ध	स ि न ् ध
सिन्धु	स ि न ् ध ु
सिन्धुपाल्चोक	स ि न ् ध ु प ा ल ् च ो क
सिन्धुपाल्चोकको	स ि न ् ध ु प ा ल ् च ो क क ो
सिन्धुली	स ि न ् ध ु ल ी
सिन्धुलीमा	स ि न ् ध ु ल ी म ा
सिप	स ि प
सिपलाई	स ि प ल ा ई
सिभिएस	स ि भ ि ए स
सिभिल	स ि भ ि ल
सिमरा	स ि म र ा
सिमसार	स ि म स ा र
सिमाना	स ि म ा न ा
सिमानाबाट	स ि म ा न ा ब ा ट
सिमानामा	स ि म ा न ा म ा
सिमानाहरूमा	स ि म ा न ा ह र ू म ा
सिमावर्ती	स ि म ा व र ् त ी
सिमेन्ट	स ि म े न ् ट
सिम्पसन्स	स ि म ् प स न ् स
सियरा	स ि य र ा
सियोले	स ि य ो ल े
सिरहा	स ि र ह ा
सिराहा	स ि र ा ह ा
सिरियाली	स ि र ि य ा ल ी
सिर्जना	स ि र ् ज न ा
सिलको	स ि ल क ो
सिलवाल	स ि ल व ा ल
सिलसिला	स ि ल स ि ल ा
सिलाइएका	स ि ल ा इ ए क ा
सिलीगुडी	स ि ल ी ग ु ड ी
सिलीगुडीसँग	स ि ल ी ग ु ड ी स ँ ग
सिल्	स ि ल ्
सिविल	स ि व ि ल
सिसाक	स ि स ा क
सिसाको	स ि स ा क ो
सिस्को	स ि स ् क ो
सिस्टम	स ि स ् ट म
सिस्टमले	स ि स ् ट म ल े
सिहंले	स ि ह ं ल े
सीता	स ी त ा
सीमान्त	स ी म ा न ् त
सीमित	स ी म ि त
सुकमित	स ु क म ि त
सुकाएर	स ु क ा ए र
सुक्दैन	स ु क ् द ै न
सुख	स ु ख
सुखद	स ु ख द
सुख्खा	स ु ख ् ख ा
सुगम	स ु ग म
सुचक	स ु च क
सुची	स ु च ी
सुझाव	स ु झ ा व
सुटर	स ु ट र
सुदाम	स ु द ा म
सुदिप	स ु द ि प
सुदुर	स ु द ु र
सुदूर	स ु द ू र
सुदूरपश्चिम	स ु द ू र प श ् च ि म
सुदूरपश्चिमका	स ु द ू र प श ् च ि म क ा
सुदूरपश्चिमाञ्चल	स ु द ू र प श ् च ि म ा ञ ् च ल
सुधार	स ु ध ा र
सुनको	स ु न क ो
सुनकोशी	स ु न क ो श ी
सुनखानीमा	स ु न ख ा न ी म ा
सुनचरी	स ु न च र ी
सुनसरीमा	स ु न स र ी म ा
सुनार	स ु न ा र
सुनारको	स ु न ा र क ो
सुनिनेछन्	स ु न ि न े छ न ्
सुनील	स ु न ी ल
सुनुवारको	स ु न ु व ा र क ो
सुनुवारले	स ु न ु व ा र ल े
सुनेको	स ु न े क ो
सुन्तला	स ु न ् त ल ा
सुन्दर	स ु न ् द र
सुन्दरी	स ु न ् द र ी
सुन्न	स ु न ् न
सुन्नोस्	स ु न ् न ो स ्
सुप	स ु प
सुपरभ्यालु	स ु प र भ ् य ा ल ु
सुप्रसिद्ध	स ु प ् र स ि द ् ध
सुब्बा	स ु ब ् ब ा
सुम	स ु म
सुमन	स ु म न
सुमात्रा	स ु म ा त ् र ा
सुमात्राको	स ु म ा त ् र ा क ो
सुमिना	स ु म ि न ा
सुमी	स ु म ी
सुरक्षा	स ु र क ् ष ा
सुरक्षामा	स ु र क ् ष ा म ा
सुरज	स ु र ज
सुरतगढका	स ु र त ग ढ क ा
सुरवीर	स ु र व ी र
सुरु	स ु र ु
सुरुआत	स ु र ु आ त
सुरुदेखि	स ु र ु द े ख ि
सुरुमा	स ु र ु म ा
सुरुवात	स ु र ु व ा त
सुरुवातका	स ु र ु व ा त क ा
सुरुवातदेखि	स ु र ु व ा त द े ख ि
सुरेन्द्र	स ु र े न ् द ् र
सुरौदी	स ु र ौ द ी
सुर्खेत	स ु र ् ख े त
सुर्खेतको	स ु र ् ख े त क ो
सुर्खेतमा	स ु र ् ख े त म ा
सुवि	स ु व ि
सुविधा	स ु व ि ध ा
सुविधाका	स ु व ि ध ा क ा
सुविधाले	स ु व ि ध ा ल े
सुविधाहरू	स ु व ि ध ा ह र ू
सुष्मा	स ु ष ् म ा
सुस्मा	स ु स ् म ा
सुस्मिता	स ु स ् म ि त ा
सूक्ष्म	स ू क ् ष ् म
सूचकाङ्क	स ू च क ा ङ ् क
सूचना	स ू च न ा
सूचनाका	स ू च न ा क ा
सूचनाको	स ू च न ा क ो
सूचि	स ू च ि
सूची	स ू च ी
सूर्य	स ू र ् य
सूर्यको	स ू र ् य क ो
सूर्यवंशी	स ू र ् य व ं श ी
सूर्या	स ू र ् य ा
सेउडोकोलोमेटहरूको	स े उ ड ो क ो ल ो म े ट ह र ू क ो
सेक्स	स े क ् स
सेटिङ्	स े ट ि ङ ्
सेती	स े त ी
सेतुराम	स े त ु र ा म
सेते	स े त े
सेना	स े न ा
सेनाको	स े न ा क ो
सेनाद्वारा	स े न ा द ् व ा र ा
सेनापति	स े न ा प त ि
सेनाहरू	स े न ा ह र ू
सेन्चुरी	स े न ् च ु र ी
सेन्ट	स े न ् ट
सेन्टर	स े न ् ट र
सेन्टरपोइन्ट	स े न ् ट र प ो इ न ् ट
सेन्टरबाट	स े न ् ट र ब ा ट
सेन्टरले	स े न ् ट र ल े
सेन्टियागो	स े न ् ट ि य ा ग ो
सेफवे	स े फ व े
सेभ्रोन	स े भ ् र ो न
सेयर	स े य र
सेयरमा	स े य र म ा
सेयरहरू	स े य र ह र ू
सेरीगाड	स े र ी ग ा ड
सेरोफेरोमा	स े र ो फ े र ो म ा
सेल्स	स े ल ् स
सेवक	स े व क
सेवकाई	स े व क ा ई
सेवा	स े व ा
सेवाको	स े व ा क ो
सेवाग्राहीहरूको	स े व ा ग ् र ा ह ी ह र ू क ो
सेवाग्राहीहरूलाई	स े व ा ग ् र ा ह ी ह र ू ल ा ई
सेवानिवृत्त	स े व ा न ि व ृ त ् त
सेवामा	स े व ा म ा
सेवाले	स े व ा ल े
सेवाहरू	स े व ा ह र ू
सैतीस	स ै त ी स
सैनिक	स ै न ि क
सैन्य	स ै न ् य
सैपाल	स ै प ा ल
सैलुन	स ै ल ु न
सैलुनमा	स ै ल ु न म ा
सो	स ो
सोचीको	स ो च ी क ो
सोचेभन्दा	स ो च े भ न ् द ा
सोडियम	स ो ड ि य म
सोताङ	स ो त ा ङ
सोन	स ो न
सोभियत	स ो भ ि य त
सोमबारबाट	स ो म ब ा र ब ा ट
सोमामा	स ो म ा म ा
सोमेश्वर	स ो म े श ् व र
सोरिया	स ो र ि य ा
सोल	स ो ल
सोलुखुम्बु	स ो ल ु ख ु म ् ब ु
सोलुखुम्वु	स ो ल ु ख ु म ् व ु
सोलुसनले	स ो ल ु स न ल े
सोलुसन्स	स ो ल ु स न ् स
सोलोमन	स ो ल ो म न
सोही	स ो ह ी
सोह्र	स ो ह ् र
सोह्रमा	स ो ह ् र म ा
सोह्रौँ	स ो ह ् र ौ ँ
सौचालय	स ौ च ा ल य
सौतेनी	स ौ त े न ी
सौन्दर्य	स ौ न ् द र ् य
सौर्य	स ौ र ् य
स्	स ्
स्कटल्यान्डको	स ् क ट ल ् य ा न ् ड क ो
स्कटिस	स ् क ट ि स
स्कि	स ् क ि
स्किखेलाडी	स ् क ि ख े ल ा ड ी
स्कुल	स ् क ु ल
स्कुलको	स ् क ु ल क ो
स्कुलमा	स ् क ु ल म ा
स्कुलले	स ् क ु ल ल े
स्केटबोर्ड	स ् क े ट ब ो र ् ड
स्कोटिया	स ् क ो ट ि य ा
स्कोनबेकको	स ् क ो न ब े क क ो
स्क्रिप्टको	स ् क ् र ि प ् ट क ो
स्क्रिप्ट्स	स ् क ् र ि प ् ट ् स
स्क्लेविग	स ् क ् ल े व ि ग
स्क्वाएर	स ् क ् व ा ए र
स्क्वायर	स ् क ् व ा य र
स्टकहोम	स ् ट क ह ो म
स्टर्स	स ् ट र ् स
स्टाइल	स ् ट ा इ ल
स्टाथेलेबाट	स ् ट ा थ े ल े ब ा ट
स्टान्डर्ड	स ् ट ा न ् ड र ् ड
स्टार	स ् ट ा र
स्टारकिड	स ् ट ा र क ि ड
स्टारकिडको	स ् ट ा र क ि ड क ो
स्टासबर्गका	स ् ट ा स ब र ् ग क ा
स्टिन्ट	स ् ट ि न ् ट
स्टुडियो	स ् ट ु ड ि य ो
स्टेज	स ् ट े ज
स्टेजमा	स ् ट े ज म ा
स्टेसन	स ् ट े स न
स्टेसनरी	स ् ट े स न र ी
स्टेसनरीमा	स ् ट े स न र ी म ा
स्टेसनरीसँग	स ् ट े स न र ी स ँ ग
स्टोइक	स ् ट ो इ क
स्टोर	स ् ट ो र
स्टोरी	स ् ट ो र ी
स्टोरीबोर्ड	स ् ट ो र ी ब ो र ् ड
स्ट्यान्लीद्वारा	स ् ट ् य ा न ् ल ी द ् व ा र ा
स्तनधारी	स ् त न ध ा र ी
स्तर	स ् त र
स्तरको	स ् त र क ो
स्तरमा	स ् त र म ा
स्तानकहरूदेखि	स ् त ा न क ह र ू द े ख ि
स्त्रोत	स ् त ् र ो त
स्थल	स ् थ ल
स्थलको	स ् थ ल क ो
स्थलमा	स ् थ ल म ा
स्थलहरूको	स ् थ ल ह र ू क ो
स्थलीय	स ् थ ल ी य
स्थान	स ् थ ा न
स्थानको	स ् थ ा न क ो
स्थानमा	स ् थ ा न म ा
स्थानीय	स ् थ ा न ी य
स्थानीयवासीले	स ् थ ा न ी य व ा स ी ल े
स्थापना	स ् थ ा प न ा
स्थापनाका	स ् थ ा प न ा क ा
स्थापनापछि	स ् थ ा प न ा प छ ि
स्थापनामा	स ् थ ा प न ा म ा
स्थापित	स ् थ ा प ि त
स्थापितले	स ् थ ा प ि त ल े
स्थायी	स ् थ ा य ी
स्थित	स ् थ ि त
स्थुं	स ् थ ु ं
स्नातक	स ् न ा त क
स्नातकाेपाधि	स ् न ा त क ा े प ा ध ि
स्नेह	स ् न े ह
स्नेही	स ् न े ह ी
स्पष्ट	स ् प ष ् ट
स्पष्टसँग	स ् प ष ् ट स ँ ग
स्पाइरल	स ् प ा इ र ल
स्पेक्ट्रल	स ् प े क ् ट ् र ल
स्पेन	स ् प े न
स्पेनको	स ् प े न क ो
स्पेनमा	स ् प े न म ा
स्पेनले	स ् प े न ल े
स्पेनी	स ् प े न ी
स्पेस	स ् प े स
स्प्रिन्टर	स ् प ् र ि न ् ट र
स्मारक	स ् म ा र क
स्मृति	स ् म ृ त ि
स्याउले	स ् य ा उ ल े
स्याङखुदी	स ् य ा ङ ख ु द ी
स्याङ्जा	स ् य ा ङ ् ज ा
स्रोत	स ् र ो त
स्लाइडहरू	स ् ल ा इ ड ह र ू
स्लेभाकिया	स ् ल े भ ा क ि य ा
स्लोभाकियाको	स ् ल ो भ ा क ि य ा क ो
स्लोभेनिया	स ् ल ो भ े न ि य ा
स्लोभेनियाई	स ् ल ो भ े न ि य ा ई
स्लोवेनियाई	स ् ल ो व े न ि य ा ई
स्वतन्त्रता	स ् व त न ् त ् र त ा
स्वयंसेवकहरूद्वारा	स ् व य ं स े व क ह र ू द ् व ा र ा
स्वयम्भू	स ् व य म ् भ ू
स्वर	स ् व र
स्वरूप	स ् व र ू प
स्वरूपराज	स ् व र ू प र ा ज
स्वर्ण	स ् व र ् ण
स्वस्तिक	स ् व स ् त ि क
स्वाद	स ् व ा द
स्वादिस्ट	स ् व ा द ि स ् ट
स्वान	स ् व ा न
स्वामित्व	स ् व ा म ि त ् व
स्वामी	स ् व ा म ी
स्वायत्त	स ् व ा य त ् त
स्वायन्त	स ् व ा य न ् त
स्वारको	स ् व ा र क ो
स्वास्थ	स ् व ा स ् थ
स्वास्थ्य	स ् व ा स ् थ ् य
स्वास्थ्यका	स ् व ा स ् थ ् य क ा
स्वास्थ्यकेन्द्र	स ् व ा स ् थ ् य क े न ् द ् र
स्वास्थ्यकेन्द्रको	स ् व ा स ् थ ् य क े न ् द ् र क ो
स्वास्थ्यकेन्द्रमा	स ् व ा स ् थ ् य क े न ् द ् र म ा
स्वास्थ्यकेन्द्रले	स ् व ा स ् थ ् य क े न ् द ् र ल े
स्वास्थ्यसम्बन्धी	स ् व ा स ् थ ् य स म ् ब न ् ध ी
स्विकार्न	स ् व ि क ा र ् न
स्विच	स ् व ि च
स्विजरल्याण्डमा	स ् व ि ज र ल ् य ा ण ् ड म ा
स्विट्जरल्यान्ड	स ् व ि ट ् ज र ल ् य ा न ् ड
स्विट्जरल्यान्डको	स ् व ि ट ् ज र ल ् य ा न ् ड क ो
स्विट्जरल्यान्डमा	स ् व ि ट ् ज र ल ् य ा न ् ड म ा
स्विडिस	स ् व ि ड ि स
स्विडेनका	स ् व ि ड े न क ा
स्विडेनको	स ् व ि ड े न क ो
स्विस	स ् व ि स
स्वेता	स ् व े त ा
हकरा	ह क र ा
हकी	ह क ी
हङकङ	ह ङ क ङ
हङकङमा	ह ङ क ङ म ा
हङेरीको	ह ङ े र ी क ो
हङेरीयन	ह ङ े र ी य न
हङ्गेरीमा	ह ङ ् ग े र ी म ा
हजरत	ह ज र त
हजार	ह ज ा र
हजारको	ह ज ा र क ो
हजारवटा	ह ज ा र व ट ा
हजारौँले	ह ज ा र ौ ँ ल े
हजुरबुबा	ह ज ु र ब ु ब ा
हटाउन	ह ट ा उ न
हटाएपछि	ह ट ा ए प छ ि
हडप्पा	ह ड प ् प ा
हडप्पाका	ह ड प ् प ा क ा
हड्डी	ह ड ् ड ी
हत्तपत्त	ह त ् त प त ् त
हत्या	ह त ् य ा
हत्याएका	ह त ् य ा ए क ा
हदसम्म	ह द स म ् म
हनिवेल	ह न ि व े ल
हनुमानगढ	ह न ु म ा न ग ढ
हनोइ	ह न ो इ
हन्डुरासको	ह न ् ड ु र ा स क ो
हमाल	ह म ा ल
हमालद्वारा	ह म ा ल द ् व ा र ा
हमालबाट	ह म ा ल ब ा ट
हरर	ह र र
हराउने	ह र ा उ न े
हराएकोमान्छे	ह र ा ए क ो म ा न ् छ े
हरिना	ह र ि न ा
हरिप्रसाद	ह र ि प ् र स ा द
हरिवंश	ह र ि व ं श
हरिश	ह र ि श
हरेक	ह र े क
हर्पन	ह र ् प न
हर्बिन	ह र ् ब ि न
हल	ह ल
हलिउड	ह ल ि उ ड
हलिउडका	ह ल ि उ ड क ा
हलुका	ह ल ु क ा
हल्का	ह ल ् क ा
हल्ला	ह ल ् ल ा
हल्स्टेनमा	ह ल ् स ् ट े न म ा
हवाइ	ह व ा इ
हवाइमार्गबाट	ह व ा इ म ा र ् ग ब ा ट
हवाई	ह व ा ई
हवाईअड्डा	ह व ा ई अ ड ् ड ा
हवाईमा	ह व ा ई म ा
हवाईमार्गहरूको	ह व ा ई म ा र ् ग ह र ू क ो
हस्तलाघव	ह स ् त ल ा घ व
हाँस	ह ा ँ स
हाँस्य	ह ा ँ स ् य
हाँस्यकलाकार	ह ा ँ स ् य क ल ा क ा र
हाइकिङ	ह ा इ क ि ङ
हाइटेक	ह ा इ ट े क
हाइपरजेन्ट	ह ा इ प र ज े न ् ट
हाइब्रिड	ह ा इ ब ् र ि ड
हाइस्कुल	ह ा इ स ् क ु ल
हाइस्कूल	ह ा इ स ् क ू ल
हाउजिङमार्केन्ट	ह ा उ ज ि ङ म ा र ् क े न ् ट
हाउस	ह ा उ स
हाउसले	ह ा उ स ल े
हाजिर	ह ा ज ि र
हात्ती	ह ा त ् त ी
हाथवेको	ह ा थ व े क ो
हानिकारक	ह ा न ि क ा र क
हानेको	ह ा न े क ो
हान्ने	ह ा न ् न े
हाबेरडासेर्सको	ह ा ब े र ड ा स े र ् स क ो
हामी	ह ा म ी
हामीले	ह ा म ी ल े
हाम्रो	ह ा म ् र ो
हार्डवेयर	ह ा र ् ड व े य र
हार्डवेयरको	ह ा र ् ड व े य र क ो
हार्डवेयरले	ह ा र ् ड व े य र ल े
हार्मोनियममा	ह ा र ् म ो न ि य म म ा
हाल	ह ा ल
हालका	ह ा ल क ा
हालको	ह ा ल क ो
हालसालै	ह ा ल स ा ल ै
हालेको	ह ा ल े क ो
हालै	ह ा ल ै
हावा	ह ा व ा
हावापानी	ह ा व ा प ा न ी
हास्य	ह ा स ् य
हास्यकलाकार	ह ा स ् य क ल ा क ा र
हाहाकार	ह ा ह ा क ा र
हिँडिसकेको	ह ि ँ ड ि स क े क ो
हिँडे	ह ि ँ ड े
हिंस्रक	ह ि ं स ् र क
हिउँका	ह ि उ ँ क ा
हिउँदे	ह ि उ ँ द े
हिउँबारीको	ह ि उ ँ ब ा र ी क ो
हिउँले	ह ि उ ँ ल े
हिक्मत	ह ि क ् म त
हिजोआज	ह ि ज ो आ ज
हिजोमात्र	ह ि ज ो म ा त ् र
हिज्र	ह ि ज ् र
हिट	ह ि ट
हिन्दु	ह ि न ् द ु
हिपहप	ह ि प ह प
हिम	ह ि म
हिमरेखामाथि	ह ि म र े ख ा म ा थ ि
हिमशिखरहरू	ह ि म श ि ख र ह र ू
हिमशृङ्खला	ह ि म श ृ ङ ् ख ल ा
हिमाल	ह ि म ा ल
हिमालको	ह ि म ा ल क ो
हिमालय	ह ि म ा ल य
हिमालयन	ह ि म ा ल य न
हिमालसम्मको	ह ि म ा ल स म ् म क ो
हिमाली	ह ि म ा ल ी
हिरण्य	ह ि र ण ् य
हिराको	ह ि र ा क ो
हिरालाल	ह ि र ा ल ा ल
हिरो	ह ि र ो
हिरोइन	ह ि र ो इ न
हिरोइनको	ह ि र ो इ न क ो
हिल	ह ि ल
हिलारी	ह ि ल ा र ी
हिलारीको	ह ि ल ा र ी क ो
हिसाब	ह ि स ा ब
हिसाबले	ह ि स ा ब ल े
हिस्पानियाका	ह ि स ् प ा न ि य ा क ा
हुँदै	ह ु ँ द ै
हुँदैन	ह ु ँ द ै न
हुउँदमा	ह ु उ ँ द म ा
हुन	ह ु न
हुनका	ह ु न क ा
हुनसक्छ	ह ु न स क ् छ
हुनाले	ह ु न ा ल े
हुनु	ह ु न ु
हुनुपर्छ	ह ु न ु प र ् छ
हुनुभएको	ह ु न ु भ ए क ो
हुनुभयो	ह ु न ु भ य ो
हुनुहुन्छ	ह ु न ु ह ु न ् छ
हुनुहुन्थ्यो	ह ु न ु ह ु न ् थ ् य ो
हुने	ह ु न े
हुन्	ह ु न ्
हुन्छ	ह ु न ् छ
हुन्छन्	ह ु न ् छ न ्
हुन्थ्यो	ह ु न ् थ ् य ो
हुम्ला	ह ु म ् ल ा
हेटौँडाको	ह े ट ौ ँ ड ा क ो
हेटौडामा	ह े ट ौ ड ा म ा
हेमन्त	ह े म न ् त
हेयर	ह े य र
हेरिएको	ह े र ि ए क ो
हेरेका	ह े र े क ा
हेर्नलायक	ह े र ् न ल ा य क
हेर्नुहोस्	ह े र ् न ु ह ो स ्
हेलम्बु	ह े ल म ् ब ु
हेल्थ	ह े ल ् थ
हेस	ह े स
हैमिल्टनको	ह ै म ि ल ् ट न क ो
हो	ह ो
होइन	ह ो इ न
होचा	ह ो च ा
होटल	ह ो ट ल
होटलको	ह ो ट ल क ो
होटलमा	ह ो ट ल म ा
होडा	ह ो ड ा
होनोलुलु	ह ो न ो ल ु ल ु
होम	ह ो म
होमियोप्याथिक	ह ो म ि य ो प ् य ा थ ि क
होल्डनस	ह ो ल ् ड न स
होल्डिङ	ह ो ल ् ड ि ङ
होल्डिङ्स	ह ो ल ् ड ि ङ ् स
होस्ट	ह ो स ् ट
ह्यमाना	ह ् य म ा न ा
ह्यातुङ	ह ् य ा त ु ङ
ह्याप्पी	ह ् य ा प ् प ी
ह्याल्लीबर्टन	ह ् य ा ल ् ल ी ब र ् ट न
ह्युस्टन	ह ् य ु स ् ट न
ालाई	ा ल ा ई
ॠग्वेद	ॠ ग ् व े द
ॠचाहरूको	ॠ च ा ह र ू क ो
ॠतुमा	ॠ त ु म ा
८	८
